node,period,deg_out_wei,tot_out_wei,ave_out_wei,max_out_wei,deg_in_wei,tot_in_wei,ave_in_wei,max_in_wei,ratio,degree_val,bet_val,tri_no,eigen_val,net_group,tot_in_wei_n,tot_out_wei_n,period_date,degree_net,overall_flux,month
South Africa,201401,4,11192,2798,5340,1,13944,13944,13944,0.109484404837683,5,49,0,1.270455350769497e-5,1,0.006086002636921904,0.004884863849141563,2014-01-01,3,25136,1
United States of America,201401,9,700300,77811.1111111111,640153,0,0,0,0,-1,9,0,2,1.1457670290344318e-4,2,0,0.30565315882360944,2014-01-01,9,700300,1
Venezuela,201401,1,9095,9095,9095,0,0,0,0,-1,1,0,0,7.510048480854025e-12,2,0,0.003969606567900511,2014-01-01,1,9095,1
Ecuador,201401,4,3916,979,3557,0,0,0,0,-1,4,0,1,4.576850130452342e-6,3,0,0.0017091785948211546,2014-01-01,4,3916,1
Germany,201401,23,8654678,376290.347826087,1900136,17,50438213,2966953.70588235,37359083,0.7070822613840301,40,724,163,0.7741098895734353,3,22.01427835051841,3.7774234889350256,2014-01-01,6,59092891,1
Greece,201401,18,7977762,443209,3485031,4,28255,7063.75,21852,-0.992941558830065,22,366,73,0.052708042520719554,3,0.012332186209568876,3.4819765181250264,2014-01-01,14,8006017,1
Italy,201401,24,819919,34163.2916666667,205457,8,2069946,258743.25,1742648,0.4325554999974047,32,843,96,0.04004958456642799,3,0.9034492838701914,0.3578621052827288,2014-01-01,16,2889865,1
Latvia,201401,4,295024,73756,196117,7,1024540,146362.857142857,803936,0.5528462431530414,11,0,29,0.01566074659062003,3,0.44717105146528746,0.12876626806907976,2014-01-01,-3,1319564,1
Morocco,201401,15,3231030,215402,1629430,0,0,0,0,-1,15,0,34,0.03558025420884653,3,0,1.4102163726315105,2014-01-01,15,3231030,1
Netherlands,201401,28,16792186,599720.928571429,7493435,10,24901591,2490159.1,24154497,0.19449916950436033,38,464,133,0.5686779401499189,3,10.868556260007944,7.329122796592304,2014-01-01,18,41693777,1
Spain,201401,36,134391311,3733091.97222222,37359083,11,1928932,175357.454545455,1629430,-0.9716999917613116,47,476,160,1,3,0.8419022689646474,58.656473976290286,2014-01-01,25,136320243,1
Turkey,201401,25,19487766,779510.64,12199143,0,0,0,0,-1,25,0,74,0.02113138031138446,3,0,8.505636493381887,2014-01-01,25,19487766,1
Australia,201401,4,17338,4334.5,8696,0,0,0,0,-1,4,0,4,6.212936329660296e-9,2,0,0.007567348947142282,2014-01-01,4,17338,1
China,201401,4,6066247,1516561.75,4956771,0,0,0,0,-1,4,0,2,0.006711292011570281,2,0,2.6476760784724322,2014-01-01,4,6066247,1
France,201401,18,1915232,106401.777777778,617608,20,12316675,615833.75,10242572,0.7308537780636144,38,1074,117,0.20494134920840507,3,5.375739854282136,0.8359227626446654,2014-01-01,-2,14231907,1
Japan,201401,2,30753,15376.5,26568,1,3762,3762,3762,-0.7820078226857888,3,1,1,1.4511953330987401e-8,2,0.001641963706260772,0.01342246407725612,2014-01-01,1,34515,1
Rep. of Korea,201401,2,21801,10900.5,18039,0,0,0,0,-1,2,0,1,9.259456083233653e-9,2,0,0.009515271334447392,2014-01-01,2,21801,1
Malaysia,201401,2,888087,444043.5,884230,8,203720,25465,187071,-0.626820491167395,10,6,13,1.6475406482339827e-05,3,0.08891569543844882,0.3876147320579506,2014-01-01,-6,1091807,1
New Zealand,201401,2,372,186,213,0,0,0,0,-1,2,0,0,8.160646402527532e-11,2,0,1.6236323730170314e-4,2014-01-01,2,372,1
Thailand,201401,4,250362,62590.5,187071,0,0,0,0,-1,4,0,2,9.2057208920701e-8,2,0,0.10927307746593817,2014-01-01,4,250362,1
Austria,201401,8,293289,36661.125,242258,1,743242,743242,743242,0.4340950728921759,9,0,22,0.003642949340336604,3,0.3243956376843883,0.12800900942198712,2014-01-01,7,1036531,1
Slovakia,201401,5,68234,13646.8,41739,10,1140581,114058.1,457349,0.8871059674143686,15,103,38,0.014136602119350411,3,0.4978183429161663,0.029781433156033363,2014-01-01,-5,1208815,1
Croatia,201401,2,717,358.5,501,5,205340,41068,99977,0.9930407605662511,7,0,9,0.00249661094647692,3,0.08962276114927882,3.12942046089573e-4,2014-01-01,-3,206057,1
Slovenia,201401,3,58519,19506.3333333333,58196,7,284492,40641.7142857143,116627,0.658792283629388,10,780,12,0.00273272932793144,3,0.1241694680280541,0.025541221192630015,2014-01-01,-4,343011,1
Indonesia,201401,2,2801,1400.5,2042,1,664,664,664,-0.6167388167388167,3,1,3,6.504583732472556e-10,2,2.8980964937723355e-4,0.0012225253432313723,2014-01-01,1,3465,1
India,201401,6,628156,104692.666666667,486350,0,0,0,0,-1,6,0,1,8.131869341187402e-7,4,0,0.27416516583464684,2014-01-01,6,628156,1
Viet Nam,201401,3,1372,457.333333333333,1254,0,0,0,0,-1,3,0,1,4.1410510274646997e-10,3,0,5.988235526288621e-4,2014-01-01,3,1372,1
Iran,201401,7,17438287,2491183.85714286,17059281,0,0,0,0,-1,7,0,2,0.023085647209600973,4,0,7.611120242785497,2014-01-01,7,17438287,1
Uzbekistan,201401,2,75568,37784,66769,0,0,0,0,-1,2,0,1,1.2174192373493604e-5,4,0,0.032982433108642746,2014-01-01,2,75568,1
Bulgaria,201401,5,1732921,346584.2,1213591,3,1220341,406780.333333333,691470,-0.17356401159125062,8,97,18,0.008610503175908812,3,0.5326304176666605,0.7563512460970556,2014-01-01,2,2953262,1
Belarus,201401,1,424464,424464,424464,4,1451500,362875,712700,0.5474710602122429,5,0,7,0.013624876936803065,4,0.6335221476973713,0.1852616912850272,2014-01-01,-3,1875964,1
Czech Rep.,201401,4,482415,120603.75,405620,10,4061476,406147.6,2185054,0.7876643607868234,14,15,48,0.0510994575337623,3,1.7726730956536882,0.2105550030185514,2014-01-01,-6,4543891,1
Lithuania,201401,3,3759729,1253243,3686331,9,5011778,556864.222222222,3030595,0.14274046637596025,12,49,43,0.06526459399593229,3,2.187442206229718,1.640972504884664,2014-01-01,-6,8771507,1
Rep. of Moldova,201401,1,580550,580550,580550,3,516820,172273.333333333,311110,-0.05807521619872969,4,0,6,0.0010964032781167307,4,0.2255714201673823,0.25338703606318214,2014-01-01,-2,1097370,1
Poland,201401,10,432683,43268.3,187075,9,10301841,1144649,8060835,0.9193847812907214,19,358,77,0.16409982517707564,3,4.4963447713102545,0.18884895861670112,2014-01-01,1,10734524,1
Romania,201401,5,21873,4374.6,14485,11,1791647,162877,790912,0.9758778508094755,16,80,59,0.009781658899461136,3,0.7819828145749583,0.009546696477150948,2014-01-01,-6,1813520,1
Ukraine,201401,1,57767,57767,57767,6,3642998,607166.333333333,3600559,0.9687810493235858,7,1,7,0.00180495155016056,3,1.5900240558162095,0.025213003035503993,2014-01-01,-5,3700765,1
Kazakhstan,201401,1,76727,76727,76727,6,1024071,170678.5,935362,0.860597493818121,7,2,4,2.243575513588153e-4,4,0.446966351577399,0.03348829061410693,2014-01-01,-5,1100798,1
Serbia,201401,3,150448,50149.3333333333,149879,8,289689,36211.125,137842,0.316358315706246,11,135,27,0.0010236937752623515,3,0.12643775228680934,0.06566458152034041,2014-01-01,-5,440137,1
Denmark,201401,4,254626,63656.5,246352,21,5208389,248018.523809524,4240573,0.9067818777726219,25,589,95,0.08624147870970464,3,2.273255105286506,0.11113414425049317,2014-01-01,-17,5463015,1
Jordan,201401,9,637048,70783.1111111111,224815,0,0,0,0,-1,9,0,17,0.002443151109060947,3,0,0.27804617095853595,2014-01-01,9,637048,1
Canada,201401,2,36540,18270,30050,16,16055335,1003458.4375,14378826,0.9954585776983726,18,399,4,0.010023169615281071,4,7.007516576783171,0.015948259922054387,2014-01-01,-14,16091875,1
Chile,201401,2,3970,1985,2026,0,0,0,0,-1,2,0,0,3.554012414631232e-7,4,0,0.0017327474518488211,2014-01-01,2,3970,1
Colombia,201401,1,263,263,263,0,0,0,0,-1,1,0,0,4.7066390755698064e-8,4,0,1.1478906293104281e-4,2014-01-01,1,263,1
Costa Rica,201401,2,3773,1886.5,3311,0,0,0,0,-1,2,0,0,5.925354364385911e-7,4,0,0.0016467647697293707,2014-01-01,2,3773,1
Dominican Rep.,201401,4,170858,42714.5,147372,0,0,0,0,-1,4,0,3,1.8368393777456357e-4,4,0,0.07457273655616772,2014-01-01,4,170858,1
Guatemala,201401,2,15869,7934.5,14019,1,9170,9170,9170,-0.2675426334917529,3,47,2,3.3213902704195775e-7,2,0.0040023410915500475,0.006926188743926686,2014-01-01,1,25039,1
Honduras,201401,4,87830,21957.5,41830,0,0,0,0,-1,4,0,2,6.487704792504843e-6,2,0,0.03833430949518437,2014-01-01,4,87830,1
Mexico,201401,2,14379612,7189806,14378826,0,0,0,0,-1,2,0,0,0.0025732298220518734,2,0,6.276129987802199,2014-01-01,2,14379612,1
Peru,201401,2,3238,1619,2529,0,0,0,0,-1,2,0,0,4.5521489281236746e-7,4,0,0.0014132585010293408,2014-01-01,2,3238,1
Philippines,201401,1,45,45,45,0,0,0,0,-1,1,0,0,8.053184742234612e-9,4,0,1.9640714189722154e-5,2014-01-01,1,45,1
Egypt,201401,4,139397,34849.25,104360,0,0,0,0,-1,4,0,1,5.000999972250906e-4,4,0,0.06084125857565998,2014-01-01,4,139397,1
Pakistan,201401,1,61,61,61,2,488264,244132,486350,0.9997501663850918,3,1,0,8.618058969697567e-7,4,0.21310785940289995,2.6624079234956698e-5,2014-01-01,-1,488325,1
Portugal,201401,7,6276,896.571428571429,3266,2,672270,336135,618930,0.9815016225871201,9,0,12,0.01109945042447387,3,0.29341917618498914,0.0027392249389932496,2014-01-01,5,678546,1
Hungary,201401,7,39418,5631.14285714286,20701,6,1195910,199318.333333333,741086,0.9361821313853487,13,978,32,0.01929386481942113,3,0.5219672557029027,0.017204392709565954,2014-01-01,1,1235328,1
Israel,201401,6,95578,15929.6666666667,55112,0,0,0,0,-1,6,0,6,1.4623795704836424e-4,3,0,0.0417160040183392,2014-01-01,6,95578,1
Estonia,201401,4,95718,23929.5,63898,5,99737,19947.4,71869,0.02056227776214474,9,59,14,0.0013786946882172002,3,0.043531242469784855,0.041777108462485,2014-01-01,-1,195455,1
United Kingdom,201401,6,312909,52151.5,215630,14,23593139,1685224.21428571,18466815,0.9738217709593824,20,539,48,0.38472808536370867,3,10.297468887497493,0.136572360808706,2014-01-01,-8,23906048,1
Trinidad and Tobago,201401,1,1503,1503,1503,0,0,0,0,-1,1,0,0,1.2877272465301075e-17,5,0,6.559998539367199e-4,2014-01-01,1,1503,1
Belgium,201401,8,775397,96924.625,473397,9,4080277,453364.111111111,2293054,0.6806222987787072,17,89,36,0.07003783495125532,3,1.7808789860421541,0.33843001912373305,2014-01-01,-1,4855674,1
Bangladesh,201401,1,1325,1325,1325,0,0,0,0,-1,1,0,0,9.101643847863155e-6,3,0,5.783099178084856e-4,2014-01-01,1,1325,1
Ireland,201401,2,13293,6646.5,13273,9,1094739,121637.666666667,452309,0.9760061081268411,11,60,22,0.015080167099735172,3,0.4778101291409387,0.005801866971643924,2014-01-01,-7,1108032,1
Lebanon,201401,3,3873,1291,2524,0,0,0,0,-1,3,0,1,1.9294774993042975e-5,6,0,0.0016904108012620867,2014-01-01,3,3873,1
Albania,201401,2,13182,6591,10341,2,136056,68028,106972,0.8233425803079645,4,0,5,1.1169737261574494e-4,3,0.05938304466215194,0.005753419876642609,2014-01-01,0,149238,1
Cameroon,201401,1,68,68,68,0,0,0,0,-1,1,0,0,8.503382070315105e-8,3,0,2.967930144224681e-5,2014-01-01,1,68,1
Luxembourg,201401,2,2068,1034,1428,8,173633,21704.125,90634,0.9764600087648904,10,478,20,0.0012216744895262417,3,0.0757839139312006,9.025999320965648e-4,2014-01-01,-6,175701,1
Suriname,201401,1,1742,1742,1742,0,0,0,0,-1,1,0,0,1.768742454604919e-5,3,0,7.603138692999109e-4,2014-01-01,1,1742,1
Brazil,201401,1,6252,6252,6252,0,0,0,0,-1,1,0,0,1.030181797224086e-17,7,0,0.002728749891425398,2014-01-01,1,6252,1
TFYR of Macedonia,201401,1,48096,48096,48096,2,78717,39358.5,78023,0.24146578032220672,3,0,3,7.456687668735775e-5,3,0.03435684664160797,0.020991995325975038,2014-01-01,-1,126813,1
Sweden,201401,2,16943,8471.5,11891,7,9088046,1298292.28571429,7108759,0.9962783041253537,9,0,20,0.14532938170533355,3,3.966571422867726,0.007394947122588054,2014-01-01,-5,9104989,1
Dominica,201401,2,1028,514,774,0,0,0,0,-1,2,0,0,6.48746684983896e-13,2,0,4.4868120415631944e-4,2014-01-01,2,1028,1
Saint Kitts and Nevis,201401,1,79,79,79,0,0,0,0,-1,1,0,0,5.15090898612043e-18,2,0,3.448036491084556e-5,2014-01-01,1,79,1
Finland,201401,1,46,46,46,5,2466205,493241,1813015,0.9999626964165448,6,44,9,0.040186734269806304,2,1.076400611961416,2.007717450504931e-5,2014-01-01,-4,2466251,1
Swaziland,201401,1,13944,13944,13944,0,0,0,0,-1,1,0,0,3.1629829415249724e-9,1,0,0.006086002636921904,2014-01-01,1,13944,1
Oman,201401,1,6797,6797,6797,0,0,0,0,-1,1,0,0,2.5173931345660357e-8,6,0,0.0029666207632786995,2014-01-01,1,6797,1
Saudi Arabia,201401,1,96205,96205,96205,0,0,0,0,-1,1,0,0,3.5631279454784335e-7,6,0,0.04198966463604933,2014-01-01,1,96205,1
Sudan,201401,1,5229,5229,5229,0,0,0,0,-1,1,0,0,1.9366556864884876e-8,6,0,0.002282250988845714,2014-01-01,1,5229,1
Namibia,201401,1,1421,1421,1421,0,0,0,0,-1,1,0,0,5.199645516254164e-6,3,0,6.202101080798929e-4,2014-01-01,1,1421,1
Tunisia,201401,1,6027,6027,6027,0,0,0,0,-1,1,0,0,2.2053668913741462e-5,3,0,0.002630546320476787,2014-01-01,1,6027,1
Russian Federation,201401,1,773,773,773,22,46083008,2094682.18181818,17059281,0.9999664524054569,23,5,80,0.07578950211171721,4,20.11340420290399,3.3738382374789386e-4,2014-01-01,-21,46083781,1
Turkmenistan,201401,1,4807,4807,4807,0,0,0,0,-1,1,0,0,1.925594698704782e-8,4,0,0.002098064735777653,2014-01-01,1,4807,1
Zambia,201401,0,0,0,0,1,1664,1664,1664,1,1,0,0,3.774529342012024e-10,1,7.262699647043925e-4,0,2014-01-01,-1,1664,1
Aruba,201401,0,0,0,0,2,31702,15851,22607,1,2,0,0,4.624761431639139e-8,2,0.013836664916501594,0,2014-01-01,-2,31702,1
"China, Hong Kong SAR",201401,0,0,0,0,10,221511,22151.1,162829,1,10,0,7,2.8745987210448595e-5,2,0.0966807609084343,0,2014-01-01,-10,221511,1
Azerbaijan,201401,0,0,0,0,1,95700,95700,95700,1,1,0,0,3.944609898573152e-5,4,0.041769252176809116,0,2014-01-01,-1,95700,1
Switzerland,201401,0,0,0,0,13,3569801,274600.076923077,3358538,1,13,0,33,0.060435864363415706,3,1.5580764701152074,0,2014-01-01,-13,3569801,1
Malta,201401,0,0,0,0,1,10697,10697,10697,1,1,0,0,7.649095429421126e-6,3,0.004668815993054619,0,2014-01-01,-1,10697,1
Barbados,201401,0,0,0,0,1,1503,1503,1503,1,1,0,0,1.030181797224086e-17,5,6.559998539367199e-4,0,2014-01-01,-1,1503,1
El Salvador,201401,0,0,0,0,3,56261,18753.6666666667,41830,1,3,0,1,5.771365694243486e-9,2,0.02455569380062129,0,2014-01-01,-3,56261,1
Armenia,201401,0,0,0,0,2,236044,118022,235648,1,2,0,0,9.727996504999303e-5,4,0.1030238386710839,0,2014-01-01,-2,236044,1
Georgia,201401,0,0,0,0,3,371503,123834.333333333,361050,1,3,0,0,1.4051704748031696e-4,4,0.16214631652498554,0,2014-01-01,-3,371503,1
Iceland,201401,0,0,0,0,3,1809,603,1666,1,3,0,1,3.0578347979308845e-5,3,7.895567104268306e-4,0,2014-01-01,-3,1809,1
Montenegro,201401,0,0,0,0,4,32936,8234,21305,1,4,0,4,1.6094509105764292e-5,3,0.014375256945615308,0,2014-01-01,-4,32936,1
Cyprus,201401,0,0,0,0,3,27771,9257,25686,1,3,0,2,4.0109671743252885e-5,3,0.012120939416950532,0,2014-01-01,-3,27771,1
Paraguay,201401,0,0,0,0,1,6252,6252,6252,1,1,0,0,1.030181797224086e-17,7,0.002728749891425398,0,2014-01-01,-1,6252,1
Norway,201401,0,0,0,0,10,3959350,395935,3905587,1,10,0,23,0.07002441921425041,3,1.7280991494905868,0,2014-01-01,-10,3959350,1
Bosnia Herzegovina,201401,0,0,0,0,3,63648,21216,32774,1,3,0,1,6.03230840505652e-4,3,0.027779826149943013,0,2014-01-01,-3,63648,1
Mauritius,201401,0,0,0,0,1,716,716,716,1,1,0,0,1.6241365120135637e-10,1,3.125055857742458e-4,0,2014-01-01,-1,716,1
Cabo Verde,201401,0,0,0,0,2,1652,826,1460,1,2,0,1,2.610576240115514e-5,3,7.210324409204666e-4,0,2014-01-01,-2,1652,1
Montserrat,201401,0,0,0,0,2,333,166.5,254,1,2,0,0,2.060363594448172e-17,2,1.4534128500394392e-4,0,2014-01-01,-2,333,1
Panama,201401,0,0,0,0,1,462,462,462,1,1,0,0,4.887728442383593e-12,4,2.0164466568114745e-4,0,2014-01-01,-1,462,1
Antigua and Barbuda,201401,0,0,0,0,4,7400,1850,5262,1,4,0,0,4.6943507158005246e-8,2,0.003229806333420976,0,2014-01-01,-4,7400,1
Singapore,201401,0,0,0,0,10,987197,98719.7,884230,1,10,0,9,1.1714936858497301e-5,2,0.43087231391002534,0,2014-01-01,-10,987197,1
Qatar,201401,0,0,0,0,13,297243,22864.8461538462,115166,1,13,0,5,2.0743579760128142e-4,6,0.1297347735087907,0,2014-01-01,-13,297243,1
Bermuda,201401,0,0,0,0,1,26357,26357,26357,1,1,0,0,5.3919066566381864e-8,2,0.01150378453107793,0,2014-01-01,-1,26357,1
Fiji,201401,0,0,0,0,1,213,213,213,1,1,0,0,3.193563571394667e-16,2,9.296604716468485e-5,0,2014-01-01,-1,213,1
Mozambique,201401,0,0,0,0,1,5340,5340,5340,1,1,0,0,1.2112972606031598e-9,1,0.0023306980838470287,0,2014-01-01,-1,5340,1
Dominican Rep.,201402,4,57238,14309.5,31616,0,0,0,0,-1,4,0,1,1.813762201333247e-4,1,0,0.027788491332764766,2014-02-01,4,57238,2
Spain,201402,39,121206003,3107846.23076923,36385779,11,2569794,233617.636363636,2027483,-0.958476631744088,50,470,166,0.9999999999999999,2,1.2476099496137338,58.84433355191587,2014-02-01,28,123775797,2
Singapore,201402,1,33,33,33,9,820195,91132.7777777778,732313,0.9999195345684371,10,20,6,1.1353406097911432e-5,1,0.39819668137735414,1.6021178482498293e-5,2014-02-01,-8,820228,2
Viet Nam,201402,3,16801,5600.33333333333,10258,0,0,0,0,-1,3,0,1,3.0972427678962395e-8,1,0,0.008156721808619812,2014-02-01,3,16801,2
Thailand,201402,4,194874,48718.5,139631,0,0,0,0,-1,4,0,2,1.2854681408330913e-6,1,0,0.09460942835146582,2014-02-01,4,194874,2
Australia,201402,4,36229,9057.25,26353,0,0,0,0,-1,4,0,3,1.6627570553965775e-8,1,0,0.017588826522497897,2014-02-01,4,36229,2
China,201402,4,5560764,1390191,4768084,0,0,0,0,-1,4,0,2,0.006201629463503275,1,0,2.6996967437288224,2014-02-01,4,5560764,2
"China, Hong Kong SAR",201402,1,439,439,439,10,249929,24992.9,178749,0.9964931620654397,11,36,6,2.9975999312862284e-5,1,0.12133809445310048,2.1313022284293184e-4,2014-02-01,-9,250368,2
Netherlands,201402,31,22623779,729799.322580645,10975304,11,18392501,1672045.54545455,17194369,-0.10316093999748392,42,501,162,0.5568097507529647,2,8.929380038197829,10.983624282048387,2014-02-01,20,41016280,2
India,201402,6,106706,17784.3333333333,62263,0,0,0,0,-1,6,0,1,5.222585957716684e-7,1,0,0.05180472336828675,2014-02-01,6,106706,2
Trinidad and Tobago,201402,1,20,20,20,0,0,0,0,-1,1,0,0,6.001142325670078e-14,1,0,9.709805140908056e-6,2014-02-01,1,20,2
United Kingdom,201402,9,295185,32798.3333333333,225541,14,21471895,1533706.78571429,15717672,0.972877850405291,23,1032,66,0.36930307357489095,2,10.4243958228019,0.14330944152594724,2014-02-01,-5,21767080,2
United States of America,201402,7,305636,43662.2857142857,254557,0,0,0,0,-1,7,0,1,4.052984957326131e-6,1,0,0.14838330020232873,2014-02-01,7,305636,2
Guatemala,201402,2,14839,7419.5,9985,1,18340,18340,18340,0.10551855089062359,3,51,2,1.5951510992330944e-7,3,0.008903891314212688,0.007204189924296733,2014-02-01,1,33179,2
Honduras,201402,4,197514,49378.5,96479,0,0,0,0,-1,4,0,3,1.5361244330962445e-6,3,0,0.09589112263006569,2014-02-01,4,197514,2
Nicaragua,201402,1,1171,1171,1171,0,0,0,0,-1,1,0,0,5.394110880359715e-14,3,0,5.685090910001667e-4,2014-02-01,1,1171,2
Turkey,201402,24,11987673,499486.375,7172712,0,0,0,0,-1,24,0,73,0.014398115036106602,2,0,5.819898446146235,2014-02-01,24,11987673,2
Morocco,201402,13,3424582,263429.384615385,2027483,0,0,0,0,-1,13,0,29,0.043135635314048223,2,0,1.6626011954530597,2014-02-01,13,3424582,2
Greece,201402,19,8513547,448081.421052632,2271392,4,74345,18586.25,67984,-0.9826860887398211,23,125,70,0.05112320132947974,2,0.03609377316004047,4.133244121398118,2014-02-01,15,8587892,2
Italy,201402,24,2082729,86780.375,1171240,7,2049289,292755.571428571,1554327,-0.008092897949621711,31,656,98,0.044629232036610955,2,0.9949098433703165,1.0111446375659148,2014-02-01,17,4132018,2
Israel,201402,6,95210,15868.3333333333,77312,0,0,0,0,-1,6,0,2,2.6810150589901635e-5,2,0,0.0462235273732928,2014-02-01,6,95210,2
Latvia,201402,3,189072,63024,103731,6,1207997,201332.833333333,947663,0.7293304768769474,9,0,16,0.019209619257389923,1,0.5864707740400755,0.0917926138800884,2014-02-01,-3,1397069,2
Brazil,201402,2,9719,4859.5,8716,0,0,0,0,-1,2,0,0,2.635225394899005e-10,2,0,0.00471847980822427,2014-02-01,2,9719,2
Germany,201402,21,8326302,396490.571428571,1781160,17,53549447,3149967.47058824,36385779,0.730870263889654,38,68,142,0.848392547135266,2,25.997734788669174,4.042338498217652,2014-02-01,4,61875749,2
Slovenia,201402,3,68944,22981.3333333333,67714,8,342126,42765.75,151740,0.6645632130780645,11,665,15,0.0037590406110978715,2,0.1660988396819155,0.033471640281738255,2014-02-01,-5,411070,2
Austria,201402,9,241899,26877.6666666667,182218,11,5749082,522643.818181818,2029709,0.9192456126968188,20,188,73,0.06575785086278706,2,2.7911232979550986,0.1174396076890259,2014-02-01,-2,5990981,2
Bulgaria,201402,5,1723975,344795,1392246,3,875187,291729,505328,-0.32656217657845105,8,0,16,0.025744837038641617,1,0.42489476159279493,0.8369730658898483,2014-02-01,2,2599162,2
France,201402,21,1413684,67318.2857142857,542954,19,9628908,506784.631578947,7841265,0.7439579403096664,40,921,130,0.17170127701673077,2,4.674741019986536,0.6863298085409733,2014-02-01,2,11042592,2
Hungary,201402,7,16487,2355.28571428571,7636,8,1241027,155128.375,703023,0.9737784231428039,15,789,43,0.021281689672540238,2,0.6025065172302851,0.008004277867907557,2014-02-01,-1,1257514,2
Poland,201402,11,676762,61523.8181818182,371537,10,9454475,945447.5,7908402,0.8664009143207291,21,216,84,0.17295586229812368,2,4.590055497979335,0.3285613573385609,2014-02-01,1,10131237,2
Slovakia,201402,4,46712,11678,27071,9,1092750,121416.666666667,579040,0.9180104294833877,13,43,29,0.016791982767415982,2,0.5305194783863639,0.022678220887104857,2014-02-01,-5,1139462,2
Belgium,201402,11,1290975,117361.363636364,855834,7,4531040,647291.428571429,1814454,0.5565195211623467,18,108,54,0.08577698916800457,2,2.199775774283002,0.6267557845891889,2014-02-01,4,5822015,2
Portugal,201402,6,387319,64553.1666666667,384663,2,302666,151333,288244,-0.12268817438060248,8,0,16,0.011834536376918461,2,0.1469413941389039,0.18803960086856839,2014-02-01,4,689985,2
TFYR of Macedonia,201402,1,53099,53099,53099,2,58581,29290.5,56526,0.049086676217765045,3,0,3,5.8943120682285096e-5,2,0.02844050474797674,0.025779047158853846,2014-02-01,-1,111680,2
Jordan,201402,9,527627,58625.2222222222,217803,0,0,0,0,-1,9,0,18,0.0025283690075757702,2,0,0.2561577678540948,2014-02-01,9,527627,2
Iran,201402,5,15652490,3130498,15166715,0,0,0,0,-1,5,0,2,0.01972173523570922,1,0,7.599131393500597,2014-02-01,5,15652490,2
Czech Rep.,201402,5,458737,91747.4,378635,12,3828963,319080.25,2628352,0.7860218765305409,17,439,74,0.05331825819709813,2,1.8589242310873368,0.22271234404623697,2014-02-01,-7,4287700,2
Estonia,201402,4,122668,30667,85331,6,200775,33462.5,70820,0.24148613511499709,10,131,19,0.0015119522348718334,2,0.09747430635829075,0.05955411885124547,2014-02-01,-2,323443,2
Croatia,201402,1,259,259,259,5,190782,38156.4,104079,0.9972885401563015,6,0,9,0.002701270401825155,2,0.09262280221963604,1.2574197657475933e-4,2014-02-01,-4,191041,2
Luxembourg,201402,5,7122,1424.4,5182,5,174001,34800.2,118961,0.9213573096735368,10,59,14,6.695765992004194e-4,2,0.08447579021615714,0.003457661610677359,2014-02-01,0,181123,2
Finland,201402,2,45300,22650,45282,5,2663266,532653.2,1769182,0.9665505658713873,7,0,14,0.04583925244013424,1,1.2929896949202817,0.02199270864415675,2014-02-01,-3,2708566,2
Lithuania,201402,4,2667047,666761.75,2587607,11,4580085,416371.363636364,2430117,0.2639717339217776,15,464,52,0.062523293383466,2,2.223586643939794,1.2948253335821704,2014-02-01,-7,7247132,2
Sri Lanka,201402,1,64,64,64,0,0,0,0,-1,1,0,0,2.1118902385431765e-7,2,0,3.107137645090578e-5,2014-02-01,1,64,2
Ecuador,201402,4,2390,597.5,1921,0,0,0,0,-1,4,0,2,3.127125108662945e-6,3,0,0.0011603217143385128,2014-02-01,4,2390,2
Lebanon,201402,3,6078,2026,4893,0,0,0,0,-1,3,0,2,3.6070931439511185e-5,2,0,0.0029508097823219585,2014-02-01,3,6078,2
Mauritius,201402,1,188,188,188,0,0,0,0,-1,1,0,0,6.203677575784689e-7,2,0,9.127216832453574e-5,2014-02-01,1,188,2
Denmark,201402,3,18694,6231.33333333333,15802,21,5539944,263806.857142857,4523069,0.9932738919138105,24,686,105,0.09690306929431776,2,2.689588836577137,0.00907575486520676,2014-02-01,-18,5558638,2
Egypt,201402,3,114626,38208.6666666667,73448,0,0,0,0,-1,3,0,1,6.58866019145011e-4,3,0,0.05564980620408634,2014-02-01,3,114626,2
Suriname,201402,1,2458,2458,2458,0,0,0,0,-1,1,0,0,2.6303076868088936e-5,2,0,0.0011933350518176001,2014-02-01,1,2458,2
Romania,201402,3,5463,1821,5217,11,1739128,158102.545454545,789765,0.9937372140518895,14,6,47,0.011343586472218278,2,0.8443296997548573,0.0026522332742390355,2014-02-01,-8,1744591,2
Cyprus,201402,1,2049,2049,2049,1,27274,27274,27274,0.8602462231013198,2,33,1,2.9386359529048425e-5,2,0.013241261270656316,9.947695366860304e-4,2014-02-01,0,29323,2
Swaziland,201402,1,6155,6155,6155,0,0,0,0,-1,1,0,0,1.38344254867093e-15,1,0,0.0029881925321144543,2014-02-01,1,6155,2
Afghanistan,201402,1,2658,2658,2658,0,0,0,0,-1,1,0,0,3.758922680919548e-9,1,0,0.0012904331032266808,2014-02-01,1,2658,2
Armenia,201402,1,297,297,297,2,227872,113936,215651,0.997396666505967,3,2,2,8.550404687538556e-5,1,0.11062963585345004,1.4419060634248464e-4,2014-02-01,-1,228169,2
Belarus,201402,1,1708756,1708756,1708756,6,1371100,228516.666666667,623700,-0.10963369715986722,7,0,17,0.014683574470679531,1,0.6656556914349518,0.8295843896678744,2014-02-01,-5,3079856,2
Kazakhstan,201402,1,43318,43318,43318,7,681091,97298.7142857143,605447,0.8804045780767494,8,5,4,1.4274724795281795e-4,1,0.33066304466131047,0.02103046695469276,2014-02-01,-6,724409,2
Rep. of Moldova,201402,1,345222,345222,345222,4,403671,100917.75,217035,0.07804719766375169,5,0,8,7.430955028316932e-4,1,0.1959783375517748,0.16760191751772804,2014-02-01,-3,748893,2
Serbia,201402,1,29976,29976,29976,6,323237,53872.8333333333,134940,0.8302667229122371,7,2,12,0.0027803240944434125,2,0.15692841421658488,0.014553055945192996,2014-02-01,-5,353213,2
Ukraine,201402,1,473284,473284,473284,3,2283022,761007.333333333,2115685,0.6565809456569771,4,0,5,0.004415892747121078,1,1.1083849376203097,0.22977477081547643,2014-02-01,-2,2756306,2
Uzbekistan,201402,2,63991,31995.5,59412,0,0,0,0,-1,2,0,1,6.116991520248421e-6,1,0,0.031067007038592373,2014-02-01,2,63991,2
Ireland,201402,2,15087,7543.5,15067,9,1022395,113599.444444444,366750,0.9709161219182598,11,128,24,0.015219840677832134,2,0.4963628113519346,0.007324591508043992,2014-02-01,-7,1037482,2
Sweden,201402,2,15450,7725,9976,7,8363072,1194724.57142857,6566960,0.9963119987033513,9,0,25,0.14612879652580849,2,4.060189974969211,0.007500824471351474,2014-02-01,-5,8378522,2
Dominica,201402,2,1867,933.5,1553,0,0,0,0,-1,2,0,0,3.116690912880327e-13,3,0,9.064103099037671e-4,2014-02-01,2,1867,2
Saint Kitts and Nevis,201402,1,77,77,77,0,0,0,0,-1,1,0,0,0,3,0,3.738274979249602e-5,2014-02-01,1,77,2
Indonesia,201402,1,1132,1132,1132,2,638,319,322,-0.2790960451977401,3,5,1,2.4711118135404345e-10,1,3.09742783994967e-4,0.00054957497097539595,2014-02-01,-1,1770,2
Japan,201402,3,30836,10278.6666666667,27481,0,0,0,0,-1,3,0,0,1.6559251221549084e-8,1,0,0.014970577566252042,2014-02-01,3,30836,2
Malaysia,201402,2,734418,367209,732313,8,161584,20198,139631,-0.6393222336557285,10,15,9,3.5836311447386362e-6,1,0.07844745769442436,0.35655278359877063,2014-02-01,-6,896002,2
New Zealand,201402,2,5265,2632.5,4929,0,0,0,0,-1,2,0,0,1.9356676286574257e-10,1,0,0.002556106203344046,2014-02-01,2,5265,2
Pakistan,201402,1,290,290,290,3,212239,70746.3333333333,193154,0.997270960668897,4,2,0,7.3585216496017e-5,1,0.10303996666505925,1.4079217454316683e-4,2014-02-01,-2,212529,2
Canada,201402,3,84153,28051,42702,14,6572317,469451.214285714,5906911,0.9747154272459727,17,332,8,8.284354970513096e-4,3,3.1907958697138707,0.040855461601141785,2014-02-01,-11,6656470,2
Chile,201402,1,1947,1947,1947,0,0,0,0,-1,1,0,0,3.0998629583741745e-8,3,0,9.452495304673993e-4,2014-02-01,1,1947,2
Costa Rica,201402,1,427,427,427,0,0,0,0,-1,1,0,0,6.798364063458066e-9,3,0,2.07304339758387e-4,2014-02-01,1,427,2
Mexico,201402,3,5909975,1969991.66666667,5906911,0,0,0,0,-1,3,0,1,9.404599954594346e-5,3,0,2.8692352818819047,2014-02-01,3,5909975,2
Kenya,201402,1,392,392,392,0,0,0,0,-1,1,0,0,1.0299185603251804e-10,2,0,1.903121807617979e-4,2014-02-01,1,392,2
Oman,201402,1,11187,11187,11187,0,0,0,0,-1,1,0,0,2.9392090420101445e-9,2,0,0.005431179505566921,2014-02-01,1,11187,2
Saudi Arabia,201402,1,89051,89051,89051,0,0,0,0,-1,1,0,0,2.339675555743034e-8,2,0,0.043233392880150164,2014-02-01,1,89051,2
South Africa,201402,2,6127,3063.5,5480,1,6155,6155,6155,0.0022797589969060414,3,2,0,1.1709431430761613e-11,1,0.0029881925321144543,0.002974598804917183,2014-02-01,1,12282,2
Rep. of Korea,201402,2,3743,1871.5,3427,0,0,0,0,-1,2,0,0,1.9742672801378822e-9,1,0,0.0018171900321209428,2014-02-01,2,3743,2
Kyrgyzstan,201402,1,153,153,153,0,0,0,0,-1,1,0,0,4.1973676910031636e-10,1,0,7.428000932794663e-5,2014-02-01,1,153,2
Russian Federation,201402,1,1226,1226,1226,22,38335344,1742515.63636364,15166715,0.9999360401830419,23,9,60,0.06765820738066786,1,18.611436012483942,5.952110551376639e-4,2014-02-01,-21,38336570,2
Turkmenistan,201402,1,1284,1284,1284,0,0,0,0,-1,1,0,0,3.5224968310743156e-9,1,0,6.233694900462972e-4,2014-02-01,1,1284,2
Colombia,201402,1,1911,1911,1911,0,0,0,0,-1,1,0,0,7.355390554397572e-14,1,0,9.277718812137648e-4,2014-02-01,1,1911,2
Venezuela,201402,1,6851,6851,6851,0,0,0,0,-1,1,0,0,2.6370098253772774e-13,1,0,0.0033260937510180546,2014-02-01,1,6851,2
Dem.Rep. of the Congo,201402,1,85,85,85,0,0,0,0,-1,1,0,0,2.82534870566483e-7,2,0,4.126667184885924e-5,2014-02-01,1,85,2
Iceland,201402,0,0,0,0,2,451,225.5,337,1,2,0,0,6.477007354041416e-6,1,2.1895610592747667e-4,0,2014-02-01,-2,451,2
Barbados,201402,0,0,0,0,3,55,18.3333333333333,22,1,3,0,0,1.5614434598321375e-7,1,2.6701964137497155e-5,0,2014-02-01,-3,55,2
El Salvador,201402,0,0,0,0,3,86717,28905.6666666667,80692,1,3,0,1,2.3970613520660048e-9,3,0.042100258620206193,0,2014-02-01,-3,86717,2
Georgia,201402,0,0,0,0,1,432086,432086,432086,1,1,0,0,1.1956213945176542e-4,2,0.20977354320571992,0,2014-02-01,-1,432086,2
Montenegro,201402,0,0,0,0,3,47627,15875.6666666667,43217,1,3,0,2,8.204810177507079e-5,2,0.023122444472301402,0,2014-02-01,-3,47627,2
Paraguay,201402,0,0,0,0,1,8716,8716,8716,1,1,0,0,4.4138655611778606e-14,2,0.004231533080407731,0,2014-02-01,-1,8716,2
Albania,201402,0,0,0,0,3,118320,39440,76016,1,3,0,1,8.904443484978366e-5,2,0.05744320721361206,0,2014-02-01,-3,118320,2
Norway,201402,0,0,0,0,8,2960253,370031.625,2878567,1,8,0,11,0.0557591830957898,2,1.437173989889425,0,2014-02-01,-8,2960253,2
Bosnia Herzegovina,201402,0,0,0,0,3,106602,35534,90765,1,3,0,1,0.0017564363194880286,2,0.05175423238155403,0,2014-02-01,-3,106602,2
Malta,201402,0,0,0,0,1,9806,9806,9806,1,1,0,0,8.410641974816303e-6,2,0.0047607174605872205,0,2014-02-01,-1,9806,2
Cabo Verde,201402,0,0,0,0,1,1900,1900,1900,1,1,0,0,3.651501173835285e-5,2,9.224314883862654e-4,0,2014-02-01,-1,1900,2
Montserrat,201402,0,0,0,0,2,391,195.5,314,1,2,0,0,-0,3,1.898266905047525e-4,0,2014-02-01,-2,391,2
New Caledonia,201402,0,0,0,0,1,4929,4929,4929,1,1,0,0,1.8331928829346735e-14,1,0.0023929814769767907,0,2014-02-01,-1,4929,2
Azerbaijan,201402,0,0,0,0,1,63800,63800,63800,1,1,0,0,2.4181522796716062e-5,1,0.0309742783994967,0,2014-02-01,-1,63800,2
Switzerland,201402,0,0,0,0,12,3697190,308099.166666667,3433341,1,12,0,27,0.06740669096627437,1,1.7949497234456928,0,2014-02-01,-12,3697190,2
Niger,201402,0,0,0,0,1,172,172,172,1,1,0,0,3.3055694836823796e-6,2,8.350432421180929e-5,0,2014-02-01,-1,172,2
Antigua and Barbuda,201402,0,0,0,0,5,12885,2577,8454,1,5,0,3,1.044278947523848e-8,3,0.006255541962030015,0,2014-02-01,-5,12885,2
Qatar,201402,0,0,0,0,13,199332,15333.2307692308,89051,1,13,0,7,1.3670959396693806e-5,2,0.09677374391737424,0,2014-02-01,-13,199332,2
Bermuda,201402,0,0,0,0,1,16335,16335,16335,1,1,0,0,1.2723657596996982e-9,1,0.007930483348836654,0,2014-02-01,-1,16335,2
Mozambique,201402,0,0,0,0,2,5500,2750,5480,1,2,0,0,7.590523185293354e-15,1,0.0026701964137497156,0,2014-02-01,-2,5500,2
Zambia,201402,0,0,0,0,2,696,348,647,1,2,0,0,9.417029344482819e-7,1,3.3790121890360037e-4,0,2014-02-01,-2,696,2
Aruba,201402,0,0,0,0,3,34475,11491.6666666667,25713,1,3,0,0,2.002836931058572e-9,1,0.01673727661164026,0,2014-02-01,-3,34475,2
Belize,201402,0,0,0,0,1,5,5,5,1,1,0,0,3.8946011840217737e-13,1,2.427451285227014e-6,0,2014-02-01,-1,5,2
Azerbaijan,201403,1,3541,3541,3541,0,0,0,0,-1,1,0,0,4.525488693343668e-6,1,0,0.0021175710315212157,2014-03-01,1,3541,3
Armenia,201403,1,1663,1663,1663,2,243100,121550,219503,0.9864113448519588,3,43,2,7.493442723444224e-5,2,0.14537744076893747,9.944989057949116e-4,2014-03-01,-1,244763,3
Belarus,201403,1,4422899,4422899,4422899,7,1307600,186800,788600,-0.5436348562315428,8,0,17,0.02658561844778671,3,0.7819643831734374,2.644959841215519,2014-03-01,-6,5730499,3
China,201403,4,7230557,1807639.25,5668250,0,0,0,0,-1,4,0,2,0.007254357765420615,3,0,4.323981373895212,2014-03-01,4,7230557,3
Czech Rep.,201403,9,510197,56688.5555555556,343615,14,5035044,359646,2879160,0.8159874385982503,23,631,94,0.1022540384184073,1,3.0110317189592513,0.30510544692714764,2014-03-01,-5,5545241,3
France,201403,23,1027435,44671.0869565217,334539,15,7576697,505113.133333333,5953860,0.7611763743280554,38,562,142,0.16957455845257197,1,4.530978277834991,0.6144215173033043,2014-03-01,8,8604132,3
Greece,201403,15,7272783,484852.2,4465621,4,48456,12114,44857,-0.9867628962802607,19,207,46,0.11896514927260761,1,0.02897741369765378,4.349233154289738,2014-03-01,11,7321239,3
Iran,201403,5,9243440,1848688,9000099,0,0,0,0,-1,5,0,2,0.011503627786736073,2,0,5.527715553686661,2014-03-01,5,9243440,3
Latvia,201403,3,151468,50489.3333333333,87899,6,818866,136477.666666667,597727,0.6878023443474103,9,50,18,0.01665711517051255,1,0.4896941316853013,0.09058013244915433,2014-03-01,-3,970334,3
Lithuania,201403,5,2440510,488102,2336449,10,3477610,347761,1785484,0.17524146181557657,15,41,54,0.07279764648506407,1,2.07966286216563,1.4594615301151772,2014-03-01,-5,5918120,3
Rep. of Moldova,201403,1,12e3,12e3,12e3,4,238697,59674.25,226085,0.9042669038720048,5,0,6,3.7086576563448843e-4,1,0.14274438082773783,0.007176179717100986,2014-03-01,-3,250697,3
Morocco,201403,9,1640504,182278.222222222,1040051,0,0,0,0,-1,9,0,19,0.026402625353182687,1,0,0.9810459608852529,2014-03-01,9,1640504,3
Netherlands,201403,34,36625688,1077226.11764706,20281867,12,7204973,600414.416666667,6302301,-0.6712359414337831,46,808,170,0.7588014191815,1,4.308681758738353,21.902709945872413,2014-03-01,22,43830661,3
Poland,201403,13,647818,49832.1538461538,421813,9,5885016,653890.666666667,3729396,0.8016732095136659,22,894,86,0.13867910304801806,1,3.5193277045012312,0.3874048659977439,2014-03-01,4,6532834,3
Slovakia,201403,5,89642,17928.4,56121,10,1236617,123661.7,627050,0.864819767481314,15,0,50,0.02588103321414934,1,0.7395154861018558,0.05360725851669721,2014-03-01,-5,1326259,3
Spain,201403,36,73688848,2046912.44444444,23511797,12,1529966,127497.166666667,1040051,-0.9593195925689549,48,253,173,0.9139069023658699,1,0.9149425814211772,44.06703469951146,2014-03-01,24,75218814,3
Turkey,201403,22,8982157,408279.863636364,6135995,0,0,0,0,-1,22,0,61,0.012423074119330597,1,0,5.371464406601386,2014-03-01,22,8982157,3
Ukraine,201403,2,2254119,1127059.5,2082819,7,286593,40941.8571428571,196115,-0.7743994596790191,9,457,13,0.003249506819854657,3,0.17138690613859356,1.3479969206443296,2014-03-01,-5,2540712,3
Uzbekistan,201403,2,418591,209295.5,416116,0,0,0,0,-1,2,0,1,5.931322913779579e-6,2,0,0.25032368699675156,2014-03-01,2,418591,3
Albania,201403,4,123632,30908,54805,0,0,0,0,-1,4,0,2,1.576981932157339e-5,1,0,0.07393378756538575,2014-03-01,4,123632,3
Italy,201403,21,1759412,83781.5238095238,683190,7,2074835,296405,1827034,0.08226465326829492,28,896,77,0.057730144855009435,1,1.2407824036109352,1.0521547257020065,2014-03-01,14,3834247,3
TFYR of Macedonia,201403,4,310467,77616.75,278373,2,94673,47336.5,54805,-0.5326405686923039,6,0,4,1.7432052591198955e-4,1,0.0566158718630918,0.18566391568576596,2014-03-01,2,405140,3
Germany,201403,24,6984106,291004.416666667,1302765,18,51884850,2882491.66666667,23511797,0.7627236331488535,42,1763,165,1,1,31.027917349568924,4.176599984940275,2014-03-01,6,58868956,3
Belgium,201403,11,2285506,207773.272727273,1156172,6,4429655,738275.833333333,3044395,0.31929971597106904,17,126,54,0.13596352538242468,1,2.6490000303962473,1.3667668167093838,2014-03-01,5,6715161,3
Canada,201403,3,65452,21817.3333333333,43143,12,2694097,224508.083333333,2047818,0.9525632630549412,15,320,5,4.1421554396188005e-4,4,1.6111103539418845,0.03914127623697448,2014-03-01,-9,2759549,3
Denmark,201403,5,46026,9205.2,43026,22,4171118,189596.272727273,3276549,0.978171957134971,27,1481,111,0.09356572467860791,1,2.4943910324362357,0.02752423730494083,2014-03-01,-17,4217144,3
Dominican Rep.,201403,3,37871,12623.6666666667,33965,0,0,0,0,-1,3,0,1,3.2252570133858757e-4,4,0,0.022647425172194285,2014-03-01,3,37871,3
Ireland,201403,2,11244,5622,11228,8,891177,111397.125,260054,0.9750803671457113,10,43,21,0.016897159613332758,1,0.5329371926455754,0.006724080394923624,2014-03-01,-6,902421,3
Jordan,201403,8,368478,46059.75,160795,0,0,0,0,-1,8,0,14,0.0025676701480193847,1,0,0.2203553624831614,2014-03-01,8,368478,3
Lebanon,201403,3,3351,1117,2050,0,0,0,0,-1,3,0,2,2.21943297740095e-5,1,0,0.00200394818600045,2014-03-01,3,3351,3
Croatia,201403,2,26688,13344,26534,7,360298,51471.1428571429,180201,0.8620725297555984,9,42,18,0.006188890295194596,1,0.21546359997600423,0.01595982369083259,2014-03-01,-5,386986,3
Guatemala,201403,2,4648,2324,3347,1,3930,3930,3930,-0.08370249475402192,3,47,2,1.3984951348655525e-8,4,0.002350198857350573,0.002779573610423782,2014-03-01,1,8578,3
Honduras,201403,4,119706,29926.5,58127,0,0,0,0,-1,4,0,3,6.156260808858849e-7,4,0,0.07158598076794088,2014-03-01,4,119706,3
Mexico,201403,2,2049107,1024553.5,2047818,0,0,0,0,-1,2,0,0,2.191626139366921e-5,4,0,1.2253966742974707,2014-03-01,2,2049107,3
Peru,201403,2,2424,1212,2265,0,0,0,0,-1,2,0,0,5.19288741939687e-9,4,0,0.001449588302854399,2014-03-01,2,2424,3
India,201403,5,42099,8419.8,27643,0,0,0,0,-1,5,0,1,8.248988462139251e-7,3,0,0.02517583249251953,2014-03-01,5,42099,3
United States of America,201403,7,560409,80058.4285714286,515474,0,0,0,0,-1,7,0,1,5.516520476903763e-6,4,0,0.3351329749234038,2014-03-01,7,560409,3
Chile,201403,2,3139,1569.5,2493,0,0,0,0,-1,2,0,0,1.075586148434908e-8,4,0,0.0018771690109983328,2014-03-01,2,3139,3
Costa Rica,201403,1,126,126,126,0,0,0,0,-1,1,0,0,1.3483613250609521e-9,4,0,7.534988702956034e-5,2014-03-01,1,126,3
Ecuador,201403,2,298,149,221,0,0,0,0,-1,2,0,0,5.218818046360742e-6,4,0,1.7820846297467448e-4,2014-03-01,2,298,3
Bulgaria,201403,5,1389185,277837,1293855,4,772522,193130.5,381783,-0.2852666897040163,9,43,18,0.036415478630162916,1,0.4619797256178573,0.8307534350250777,2014-03-01,1,2161707,3
Austria,201403,9,130015,14446.1111111111,71696,9,3324197,369355.222222222,1015517,0.9247208914797355,18,0,64,0.04699868152393909,1,1.9879195905873286,0.07775091715990705,2014-03-01,0,3454212,3
Israel,201403,6,92752,15458.6666666667,60872,0,0,0,0,-1,6,0,7,2.8920999345105104e-4,1,0,0.05546708509337921,2014-03-01,6,92752,3
Romania,201403,4,45939,11484.75,44750,11,2101378,191034.363636364,800809,0.9572126518813944,15,44,55,0.025559242170078125,1,1.2566555151301861,0.027472210001991848,2014-03-01,-7,2147317,3
United Kingdom,201403,9,463819,51535.4444444444,227471,14,16496754,1178339.57142857,10076083,0.9453062110578457,23,450,63,0.36750866988706976,1,9.865305954400378,0.27737070835050515,2014-03-01,-5,16960573,3
Estonia,201403,4,48877,12219.25,29907,5,186071,37214.2,86625,0.5839334661286752,9,83,15,0.0027599336048204134,1,0.11127324467839146,0.02922917800272874,2014-03-01,-1,234948,3
Portugal,201403,8,417583,52197.875,407589,2,376345,188172.5,376323,-0.05194173778982477,10,854,14,0.019433873516697724,1,0.22505994630269752,0.24972088790051505,2014-03-01,6,793928,3
Luxembourg,201403,2,553,276.5,346,6,175038,29173,143853,0.9937012717052697,8,202,13,0.0010856115012917295,1,0.10467534544349352,3.307022819630704e-4,2014-03-01,-4,175591,3
Russian Federation,201403,2,1719,859.5,1595,19,32632067,1717477.21052632,9000099,0.9998946490609456,21,780,64,0.049468667143309046,1,19.5144647777067,0.0010279877444747162,2014-03-01,-17,32633786,3
Egypt,201403,3,29009,9669.66666666667,27354,0,0,0,0,-1,3,0,1,7.375874179364178e-4,1,0,0.017347816451115206,2014-03-01,3,29009,3
Slovenia,201403,3,54328,18109.3333333333,32814,9,508617,56513,268747,0.8069864729236427,12,921,26,0.007243422899864885,1,0.304160583264396,0.03248895763922186,2014-03-01,-6,562945,3
Suriname,201403,1,1230,1230,1230,0,0,0,0,-1,1,0,0,2.4112519629481207e-5,1,0,7.35558421002851e-4,2014-03-01,1,1230,3
Dem.Rep. of the Congo,201403,1,140,140,140,0,0,0,0,-1,1,0,0,5.015894669542976e-7,1,0,8.37220966995115e-5,2014-03-01,1,140,3
Ethiopia,201403,1,2582,2582,2582,0,0,0,0,-1,1,0,0,9.250742883312516e-6,1,0,0.001544074669129562,2014-03-01,1,2582,3
Australia,201403,4,44806,11201.5,36480,0,0,0,0,-1,4,0,4,2.2848035981522453e-7,3,0,0.02679465903370223,2014-03-01,4,44806,3
Indonesia,201403,2,1646,823,1221,2,577,288.5,322,-0.4808816914080072,4,90,3,7.149090858641401e-10,3,3.450546413972724e-4,9.843326511956851e-4,2014-03-01,0,2223,3
Japan,201403,4,47278,11819.5,42367,0,0,0,0,-1,4,0,2,2.637335943765734e-7,3,0,0.028272952055425033,2014-03-01,4,47278,3
Viet Nam,201403,3,9652,3217.33333333333,4586,0,0,0,0,-1,3,0,2,2.98258386930795e-8,3,0,0.005772040552454893,2014-03-01,3,9652,3
Thailand,201403,3,305427,101809,227030,0,0,0,0,-1,3,0,2,1.0073256159902516e-7,3,0,0.18264992020458357,2014-03-01,3,305427,3
Hungary,201403,3,6265,2088.33333333333,6173,8,1472637,184079.625,960262,0.9915274981033226,11,705,45,0.034165959760427966,1,0.8806589808377037,0.0037465638273031393,2014-03-01,-5,1478902,3
Brazil,201403,2,4140,2070,3739,0,0,0,0,-1,2,0,0,1.7567680315809577e-6,1,0,0.00247578200239984,2014-03-01,2,4140,3
Serbia,201403,1,1019,1019,1019,6,763296,127216,278373,0.9973335601159208,7,0,7,0.006705756804484324,1,0.45646243944535947,6.093772609771586e-4,2014-03-01,-5,764315,3
Sweden,201403,2,17720,8860,12480,8,4379107,547388.375,2671487,0.991939641928145,10,0,25,0.09307482587576647,1,2.618771569367912,0.010596825382252454,2014-03-01,-6,4396827,3
Seychelles,201403,1,6212,6212,6212,0,0,0,0,-1,1,0,0,5.215047255868887e-7,3,0,0.0037148690335526103,2014-03-01,1,6212,3
"China, Hong Kong SAR",201403,1,7500,7500,7500,10,314143,31414.3,207091,0.9533644444306265,11,379,7,2.3874101913345136e-4,3,0.18786221873910458,0.0044851123231881155,2014-03-01,-9,321643,3
South Africa,201403,3,11582,3860.66666666667,9870,0,0,0,0,-1,3,0,0,9.52113979403242e-10,1,0,0.006926209456955301,2014-03-01,3,11582,3
Afghanistan,201403,1,2023,2023,2023,0,0,0,0,-1,1,0,0,7.861647851452688e-12,2,0,0.001209784297307941,2014-03-01,1,2023,3
Finland,201403,1,31,31,31,4,1461288,365322,671079,0.9999575725765558,5,0,9,0.03244373030787843,1,0.8738721088702553,1.8538464269177547e-5,2014-03-01,-3,1461319,3
Dominica,201403,2,491,245.5,247,0,0,0,0,-1,2,0,0,3.3703924839904546e-14,4,0,2.936253534247153e-4,2014-03-01,2,491,3
Saint Kitts and Nevis,201403,1,37,37,37,0,0,0,0,-1,1,0,0,2.8408567801672747e-18,4,0,2.212655412772804e-5,2014-03-01,1,37,3
New Zealand,201403,3,4051,1350.33333333333,3866,0,0,0,0,-1,3,0,0,1.0362051752896733e-9,4,0,0.002422558669498008,2014-03-01,3,4051,3
Malaysia,201403,2,792578,396289,787961,8,251312,31414,227030,-0.518508655126498,10,215,14,9.870151916261772e-6,3,0.15028833975534023,0.47397351398503873,2014-03-01,-6,1043890,3
Pakistan,201403,1,78,78,78,1,2023,2023,2023,0.9257496430271299,2,1,0,1.504208598401052e-7,2,0.001209784297307941,4.6645168161156405e-5,2014-03-01,0,2101,3
Saudi Arabia,201403,1,117962,117962,117962,0,0,0,0,-1,1,0,0,1.8183250402010622e-7,5,0,0.07054304264905553,2014-03-01,1,117962,3
Colombia,201403,1,2545,2545,2545,0,0,0,0,-1,1,0,0,3.922989802936235e-9,5,0,0.001521948115001834,2014-03-01,1,2545,3
Kenya,201403,1,9616,9616,9616,0,0,0,0,-1,1,0,0,1.482258149579111e-8,5,0,0.005750512013303589,2014-03-01,1,9616,3
Oman,201403,1,12557,12557,12557,0,0,0,0,-1,1,0,0,1.93559854252097e-8,5,0,0.007509274058969756,2014-03-01,1,12557,3
Mauritius,201403,1,119,119,119,2,1183,591.5,1104,0.8172043010752689,3,89,0,5.228405669748747e-7,1,7.074517171108721e-4,7.116378219458477e-5,2014-03-01,-1,1302,3
Rep. of Korea,201403,2,8008,4004,7753,0,0,0,0,-1,2,0,0,4.781963077519988e-8,3,0,0.004788903931212058,2014-03-01,2,8008,3
Kyrgyzstan,201403,1,4306,4306,4306,0,0,0,0,-1,1,0,0,2.864564258113046e-8,2,0,0.0025750524884864037,2014-03-01,1,4306,3
Turkmenistan,201403,1,10917,10917,10917,0,0,0,0,-1,1,0,0,7.262528565569844e-8,2,0,0.006528529497632622,2014-03-01,1,10917,3
Venezuela,201403,1,6541,6541,6541,0,0,0,0,-1,1,0,0,6.457636772701637e-13,4,0,0.003911615960796462,2014-03-01,1,6541,3
Georgia,201403,0,0,0,0,2,950615,475307.5,932335,1,2,0,0,3.0466639600847486e-4,2,0.5684820068143295,0,2014-03-01,-2,950615,3
Bosnia Herzegovina,201403,0,0,0,0,6,240837,40139.5,206591,1,6,0,8,0.004916345014599022,1,0.1440241328772875,0,2014-03-01,-6,240837,3
Cyprus,201403,0,0,0,0,3,31587,10529,22200,1,3,0,1,7.212631004814451e-5,1,0.018889499060339068,0,2014-03-01,-3,31587,3
Malta,201403,0,0,0,0,2,8418,4209,8266,1,2,0,1,1.5308177816724517e-5,1,0.0050340900715463415,0,2014-03-01,-2,8418,3
Paraguay,201403,0,0,0,0,1,3739,3739,3739,1,1,0,0,1.6969898316495494e-10,1,0.002235977996853382,0,2014-03-01,-1,3739,3
Barbados,201403,0,0,0,0,1,218,218,218,1,1,0,0,3.1069271649125716e-11,4,1.303672648606679e-4,0,2014-03-01,-1,218,3
El Salvador,201403,0,0,0,0,2,61474,30737,58127,1,2,0,1,9.257036475338846e-10,4,0.0367623726607555,0,2014-03-01,-2,61474,3
Iceland,201403,0,0,0,0,3,5917,1972.33333333333,3511,1,3,0,1,1.2904511699531962e-4,1,0.003538454615507211,0,2014-03-01,-3,5917,3
Montenegro,201403,0,0,0,0,4,52927,13231.75,35648,1,4,0,3,6.649426541916903e-5,1,0.03165113865725032,0,2014-03-01,-4,52927,3
Norway,201403,0,0,0,0,6,1229431,204905.166666667,805676,1,6,0,9,0.026547518390733372,1,0.7352181504812652,0,2014-03-01,-6,1229431,3
Cabo Verde,201403,0,0,0,0,2,1292,646,1173,1,2,0,1,2.7755253810909218e-5,1,7.726353495412061e-4,0,2014-03-01,-2,1292,3
Montserrat,201403,0,0,0,0,2,281,140.5,244,1,2,0,0,-0,4,1.6804220837544808e-4,0,2014-03-01,-2,281,3
New Caledonia,201403,0,0,0,0,1,3866,3866,3866,1,1,0,0,1.0349525335827398e-13,4,0.0023119258988593674,0,2014-03-01,-1,3866,3
Antigua and Barbuda,201403,0,0,0,0,4,4737,1184.25,3928,1,4,0,2,5.2810060524868355e-9,4,0.002832796943325614,0,2014-03-01,-4,4737,3
Singapore,201403,0,0,0,0,10,907932,90793.2,787961,1,10,0,9,1.915764039993404e-5,3,0.5429569335755776,0,2014-03-01,-10,907932,3
Switzerland,201403,0,0,0,0,12,3330577,277548.083333333,2903572,1,12,0,29,0.07464558306026627,2,1.9917349261369208,0,2014-03-01,-12,3330577,3
Qatar,201403,0,0,0,0,16,199644,12477.75,117962,1,16,0,9,5.96650548115581e-5,5,0.1193901019534091,0,2014-03-01,-16,199644,3
Bermuda,201403,0,0,0,0,1,10496,10496,10496,1,1,0,0,1.4958856824523522e-9,4,0.006276765192557662,0,2014-03-01,-1,10496,3
Mozambique,201403,0,0,0,0,2,9880,4940,9870,1,2,0,0,3.1092041116218757e-13,3,0.005908387967079811,0,2014-03-01,-2,9880,3
Kazakhstan,201403,0,0,0,0,8,1777275,222159.375,1338992,1,8,0,6,2.574987914147405e-4,2,1.0628370672258878,0,2014-03-01,-8,1777275,3
Aruba,201403,0,0,0,0,2,33354,16677,26813,1,2,0,0,3.821378043304925e-9,4,0.01994619152368219,0,2014-03-01,-2,33354,3
Senegal,201403,0,0,0,0,1,1046,1046,1046,1,1,0,0,3.357145074969992e-7,1,6.255236653406359e-4,0,2014-03-01,-1,1046,3
French Polynesia,201403,0,0,0,0,2,2921,1460.5,2904,1,2,0,0,4.1387736761432833e-10,4,0.0017468017461376648,0,2014-03-01,-2,2921,3
Estonia,201404,4,38462,9615.5,22492,8,549763,68720.375,219971,0.8692269114709508,12,94,21,0.002986541218788822,1,0.40867185038277287,0.028591114188154187,2014-04-01,-4,588225,4
Lithuania,201404,5,1694169,338833.8,1550706,6,1759330,293221.666666667,1265770,0.018868110284670708,11,0,19,0.040836108445170785,1,1.307815634253167,1.2593775501282043,2014-04-01,-1,3453499,4
Netherlands,201404,34,51224093,1506590.97058824,25842783,11,3217768,292524.363636364,1723586,-0.8817906683976141,45,1159,167,0.9141768561044711,2,2.3919601767715806,38.077944260507245,2014-04-01,23,54441861,4
Poland,201404,13,570853,43911.7692307692,254461,12,1949648,162470.666666667,925955,0.5470321178210205,25,634,106,0.047421612788159484,1,1.4492904319771835,0.42434931380714425,2014-04-01,1,2520501,4
Spain,201404,34,36406334,1070774.52941176,17383633,12,272267,22688.9166666667,129746,-0.9851539048613114,46,436,160,0.5961422186941603,3,0.20239241034439645,27.06301421054756,2014-04-01,22,36678601,4
Denmark,201404,5,49282,9856.4,26866,21,1660767,79084.1428571429,734153,0.9423618855366133,26,875,104,0.03633591102280418,4,1.2345478377858214,0.03663426991369702,2014-04-01,-16,1710049,4
Germany,201404,21,3055309,145490.904761905,506062,18,46799521,2599973.38888889,25842783,0.877431775416745,39,440,141,1,3,34.788894203679476,2.271194646640715,2014-04-01,3,49854830,4
Italy,201404,20,993792,49689.6,201945,9,1891440,210160,1685378,0.3111181353873796,29,560,86,0.0371379403150615,3,1.406020930269938,0.7387452693898946,2014-04-01,11,2885232,4
Jordan,201404,6,152072,25345.3333333333,50513,0,0,0,0,-1,6,0,9,9.754187882901528e-4,4,0,0.1130442493063539,2014-04-01,6,152072,4
Turkey,201404,19,8435646,443981.368421053,5676224,0,0,0,0,-1,19,0,53,0.007316128157794624,5,0,6.270722220291356,2014-04-01,19,8435646,4
Iran,201404,6,5899880,983313.333333333,5647843,0,0,0,0,-1,6,0,3,0.004448009355519644,6,0,4.385735083365585,2014-04-01,6,5899880,4
Guatemala,201404,2,10444,5222,10055,0,0,0,0,-1,2,0,0,4.359519447661934e-9,7,0,0.007763652347279973,2014-04-01,2,10444,4
Honduras,201404,2,4616,2308,3445,0,0,0,0,-1,2,0,0,3.860807711140698e-8,7,0,0.0034313499842057024,2014-04-01,2,4616,4
Chile,201404,2,2690,1345,1374,0,0,0,0,-1,2,0,0,2.0880783728837312e-8,7,0,0.001999638530657136,2014-04-01,2,2690,4
Costa Rica,201404,2,6732,3366,6432,0,0,0,0,-1,2,0,0,3.2069162403419425e-8,7,0,0.00500429984698284,2014-04-01,2,6732,4
Mexico,201404,1,1284158,1284158,1284158,0,0,0,0,-1,1,0,0,1.4391544557255913e-5,7,0,0.9545917532533853,2014-04-01,1,1284158,4
Peru,201404,2,1073,536.5,1033,0,0,0,0,-1,2,0,0,5.05872713320041e-9,7,0,7.976253321171402e-4,2014-04-01,2,1073,4
United States of America,201404,8,506219,63277.375,471728,0,0,0,0,-1,8,0,2,5.287658546320264e-6,8,0,0.3763029804277787,2014-04-01,8,506219,4
Canada,201404,2,66128,33064,44619,10,1788950,178895,1284158,0.9287059627681423,12,273,1,3.894664466659914e-4,7,1.3298339588918526,0.04915691329193126,2014-04-01,-8,1855078,4
Dominican Rep.,201404,4,33987,8496.75,30109,0,0,0,0,-1,4,0,4,2.6222457206579944e-4,7,0,0.025264577970797057,2014-04-01,4,33987,4
India,201404,6,33085,5514.16666666667,22349,0,0,0,0,-1,6,0,2,1.8955066839114088e-5,9,0,0.02459406720698563,2014-04-01,6,33085,4
Brazil,201404,1,5785,5785,5785,0,0,0,0,-1,1,0,0,0,10,0,0.0043003378809857,2014-04-01,1,5785,4
Austria,201404,11,361707,32882.4545454545,123127,10,1251623,125162.3,510169,0.5516019661197648,21,174,84,0.024139904920199337,5,0.9304065340731139,0.2688785330886248,2014-04-01,1,1613330,4
Slovakia,201404,5,44911,8982.2,21762,11,936997,85181.5454545455,474410,0.9085229980812867,16,61,47,0.01663187032899239,5,0.6965261354312805,0.03338504314139131,2014-04-01,-6,981908,4
Slovenia,201404,2,8255,4127.5,8082,8,536449,67056.125,240187,0.9696899600516978,10,502,20,0.004431116891596755,4,0.3987747546960929,0.006136437200957122,2014-04-01,-6,544704,4
TFYR of Macedonia,201404,8,1359514,169939.25,1106557,2,160932,80466,159222,-0.7883094828754195,10,55,16,1.4216996202186496e-4,5,0.11963041933669673,1.0106083930735337,2014-04-01,6,1520446,4
Belgium,201404,12,3084535,257044.583333333,1529127,6,5265888,877648,4499239,0.26122664684172286,18,10,57,0.2001873789956855,3,3.9144507594516895,2.2929200874202635,2014-04-01,6,8350423,4
Bulgaria,201404,6,971949,161991.5,714118,6,601377,100229.5,335573,-0.23553414867611672,12,39,26,0.021735024634667758,11,0.44703963592973844,0.722508055848949,2014-04-01,0,1573326,4
Croatia,201404,6,45794,7632.33333333333,25717,7,507975,72567.8571428571,203681,0.8346097379954458,13,121,30,0.004803697965305088,3,0.37760832067307015,0.034041430064279884,2014-04-01,-1,553769,4
France,201404,16,1165265,72829.0625,323694,15,6454404,430293.6,4012323,0.6941428820595751,31,68,97,0.12400500771109908,3,4.797946070939607,0.8662114469985828,2014-04-01,1,7619669,4
Greece,201404,15,2400667,160044.466666667,705817,3,4692,1564,2507,-0.9960987112526654,18,276,55,0.03376734620782089,5,0.003487845347897131,1.7845599377238197,2014-04-01,12,2405359,4
Israel,201404,6,18984,3164,11602,0,0,0,0,-1,6,0,8,1.5512646616103302e-5,4,0,0.014111947162079952,2014-04-01,6,18984,4
Romania,201404,6,260395,43399.1666666667,106386,11,763304,69391.2727272727,186660,0.49126647579024696,17,0,59,0.005025369752556173,5,0.5674096985147637,0.19356723984775648,2014-04-01,-5,1023699,4
Sweden,201404,5,172991,34598.2,126660,7,2006078,286582.571428571,1661869,0.8412248533662771,12,0,27,0.04886379853686113,4,1.4912382395180692,0.12859459816241955,2014-04-01,-2,2179069,4
United Kingdom,201404,10,205436,20543.6,85918,15,12464351,830956.733333333,9905590,0.9675707255378484,25,1162,64,0.3024720681588864,12,9.265500564771303,0.15271291493831948,2014-04-01,-5,12669787,4
Lebanon,201404,2,869,434.5,699,0,0,0,0,-1,2,0,0,2.4949818323249388e-6,9,0,6.459798822085692e-4,2014-04-01,2,869,4
Luxembourg,201404,3,3656,1218.66666666667,2979,4,146685,36671.25,127915,0.951363899402026,7,145,9,8.599674107094415e-4,13,0.10903976872469963,0.0027177243375771337,2014-04-01,-1,150341,4
Morocco,201404,5,40791,8158.2,20300,0,0,0,0,-1,5,0,5,2.607966019995197e-4,14,0,0.03032239974127704,2014-04-01,5,40791,4
Portugal,201404,5,14261,2852.2,10253,3,136173,45391,135999,0.8104019038249332,8,551,17,0.0023685080416284486,13,0.1012255678941168,0.010601057652677107,2014-04-01,2,150434,4
Latvia,201404,3,269579,89859.6666666667,219971,5,551105,110221,315278,0.3430382461458978,8,0,14,0.008766280685604512,1,0.40966943956795576,0.20039425853383647,2014-04-01,-2,820684,4
Albania,201404,5,391310,78262,159222,0,0,0,0,-1,5,0,4,7.134353232976852e-5,11,0,0.2908842206064847,2014-04-01,5,391310,4
Hungary,201404,5,12259,2451.8,11490,9,1248976,138775.111111111,834137,0.9805603238095993,14,909,50,0.025062301000327348,5,0.9284388600245453,0.009112850835437112,2014-04-01,-4,1261235,4
Viet Nam,201404,2,11572,5786,8187,0,0,0,0,-1,2,0,1,9.23339286446256e-9,15,0,0.008602162482068541,2014-04-01,2,11572,4
Thailand,201404,4,387751,96937.75,307415,0,0,0,0,-1,4,0,2,1.5813309045550972e-6,15,0,0.288238602193619,2014-04-01,4,387751,4
Australia,201404,4,24778,6194.5,17200,0,0,0,0,-1,4,0,4,3.175862754146835e-8,16,0,0.018418975283502795,2014-04-01,4,24778,4
China,201404,4,7987802,1996950.5,6984064,0,0,0,0,-1,4,0,2,0.005503749753481064,16,0,5.937812882698934,2014-04-01,4,7987802,4
Indonesia,201404,2,8422,4211,5095,1,323,323,323,-0.9261292166952544,3,0,3,5.1475835469705184e-9,16,2.401052956885706e-4,0.00626057832906855,2014-04-01,1,8745,4
Japan,201404,3,39204,13068,34769,0,0,0,0,-1,3,0,2,5.8292889103627724e-8,16,0,0.029142687344194187,2014-04-01,3,39204,4
Panama,201404,1,14065,14065,14065,1,316,316,316,-0.9560531256519018,2,42,0,1.3364360215437665e-6,8,2.3490177534857062e-4,0.010455359083157107,2014-04-01,0,14381,4
Ireland,201404,2,15005,7502.5,14979,8,626580,78322.5,423768,0.9532252156768004,10,12,19,0.013827994930488767,12,0.4657745392338841,0.011154117528814247,2014-04-01,-6,641585,4
Kenya,201404,2,7443,3721.5,6037,0,0,0,0,-1,2,0,1,1.2264353620847226e-5,9,0,0.005532828841517124,2014-04-01,2,7443,4
Mauritius,201404,1,2101,2101,2101,0,0,0,0,-1,1,0,0,1.8286484615342858e-5,12,0,0.001561799462048566,2014-04-01,1,2101,4
Guyana,201404,1,699,699,699,0,0,0,0,-1,1,0,0,0,17,0,5.196086739514267e-4,2014-04-01,1,699,4
Ukraine,201404,3,3190149,1063383,2935210,4,332340,83085,194111,-0.8113038819993477,7,86,11,0.0033019760195314245,8,0.24704827854222772,2.371429315590086,2014-04-01,-1,3522489,4
Finland,201404,2,23045,11522.5,22985,4,814388,203597,595387,0.9449627612000004,6,0,9,0.019542302430704324,1,0.6053835032359866,0.017130732319328514,2014-04-01,-2,837433,4
Serbia,201404,1,138,138,138,5,1445604,289120.8,1106557,0.9998090945687405,6,109,7,0.0029721350659354783,11,1.0746042596550478,1.0258368670285679e-4,2014-04-01,-4,1445742,4
Egypt,201404,2,11423,5711.5,10304,0,0,0,0,-1,2,0,1,3.259360613390055e-4,2,0,0.0084914018348314,2014-04-01,2,11423,4
Sri Lanka,201404,1,856,856,856,0,0,0,0,-1,1,0,0,2.4631602159278314e-5,3,0,6.363162015771407e-4,2014-04-01,1,856,4
Suriname,201404,1,2238,2238,2238,0,0,0,0,-1,1,0,0,5.887205574042563e-5,2,0,0.0016636397887028515,2014-04-01,1,2238,4
Azerbaijan,201404,1,1398,1398,1398,1,165880,165880,165880,0.9832853094848097,2,0,1,2.23322653585315e-5,6,0.12330856485702815,0.0010392173479028535,2014-04-01,0,167278,4
Armenia,201404,1,7244,7244,7244,1,22568,22568,22568,0.514021199516973,2,1,1,8.59288047000939e-6,6,0.016776149576159943,0.00538490019185141,2014-04-01,0,29812,4
Belarus,201404,1,7306766,7306766,7306766,6,1119200,186533.333333333,378400,-0.7343449997305946,7,0,16,0.01906124103208418,8,0.83196856636114,5.431557928660045,2014-04-01,-5,8425966,4
Czech Rep.,201404,6,629260,104876.666666667,549284,17,4848288,285193.411764706,1706050,0.7702402607882213,23,30,105,0.08895428383878701,3,3.6040236031682618,0.46776674416405556,2014-04-01,-11,5477548,4
Kazakhstan,201404,1,78080,78080,78080,9,1249355,138817.222222222,709376,0.8823595882284255,10,4,6,1.7880261615923725e-4,18,0.928720593482954,0.05804155259245694,2014-04-01,-8,1327435,4
Uzbekistan,201404,2,467632,233816,463740,0,0,0,0,-1,2,0,1,5.450769166208275e-6,6,0,0.3476189462335531,2014-04-01,2,467632,4
Dominica,201404,2,323,161.5,304,0,0,0,0,-1,2,0,0,1.9196883877521335e-16,19,0,2.401052956885706e-4,2014-04-01,2,323,4
Eritrea,201404,1,2833,2833,2833,0,0,0,0,-1,1,0,0,3.7469200230502748e-6,14,0,0.00210593901760285,2014-04-01,1,2833,4
Tunisia,201404,1,6,6,6,0,0,0,0,-1,1,0,0,7.935587759218843e-9,14,0,4.4601602914285565e-6,2014-04-01,1,6,4
Malaysia,201404,2,798687,399343.5,795578,9,346246,38471.7777777778,307415,-0.39516810153956605,11,6,15,1.638718638342177e-5,16,0.257385443377662,0.5937120071133666,2014-04-01,-7,1144933,4
South Africa,201404,2,12015,6007.5,12010,0,0,0,0,-1,2,0,0,0,20,0,0.008931470983585684,2014-04-01,2,12015,4
Colombia,201404,1,3105,3105,3105,0,0,0,0,-1,1,0,0,1.3858121739499121e-8,9,0,0.0023081329508142776,2014-04-01,1,3105,4
Oman,201404,1,13071,13071,13071,0,0,0,0,-1,1,0,0,5.8338006220019294e-8,9,0,0.00971645919487711,2014-04-01,1,13071,4
Saudi Arabia,201404,1,147860,147860,147860,0,0,0,0,-1,1,0,0,6.599233111532781e-7,9,0,0.10991321678177106,2014-04-01,1,147860,4
United Rep. of Tanzania,201404,1,1833,1833,1833,0,0,0,0,-1,1,0,0,8.180978145040648e-9,9,0,0.0013625789690314238,2014-04-01,1,1833,4
New Zealand,201404,2,577,288.5,406,0,0,0,0,-1,2,0,0,6.44424850128854e-10,15,0,4.289187480257128e-4,2014-04-01,2,577,4
Afghanistan,201404,1,16e3,16e3,16e3,0,0,0,0,-1,1,0,0,8.232140010888615e-8,18,0,0.011893760777142817,2014-04-01,1,16e3,4
Kyrgyzstan,201404,1,75,75,75,0,0,0,0,-1,1,0,0,3.858815540118645e-10,18,0,5.5752003642856955e-5,2014-04-01,1,75,4
Russian Federation,201404,1,1738,1738,1738,19,31778531,1672554.26315789,7306766,0.9998906239591616,20,5,45,0.027365820077909456,6,23.622890347688568,0.0012919597644171384,2014-04-01,-18,31780269,4
Turkmenistan,201404,1,49846,49846,49846,0,0,0,0,-1,1,0,0,2.564620318849378e-7,18,0,0.0370535249810913,2014-04-01,1,49846,4
Venezuela,201404,1,17697,17697,17697,0,0,0,0,-1,1,0,0,1.5634262177918e-12,8,0,0.013155242779568527,2014-04-01,1,17697,4
Dem.Rep. of the Congo,201404,1,52,52,52,0,0,0,0,-1,1,0,0,7.095754157763152e-8,1,0,3.865472252571415e-5,2014-04-01,1,52,4
Ecuador,201404,1,394,394,394,0,0,0,0,-1,1,0,0,5.376398343174809e-7,1,0,2.928838591371419e-4,2014-04-01,1,394,4
Rep. of Korea,201404,1,4652,4652,4652,0,0,0,0,-1,1,0,0,7.383902684495786e-9,15,0,0.003458110945954274,2014-04-01,1,4652,4
Iceland,201404,0,0,0,0,2,2414,1207,2095,1,2,0,1,6.0582515554166555e-5,2,0.0017944711572514223,0,2014-04-01,-2,2414,4
Georgia,201404,0,0,0,0,2,1372112,686056,1323904,1,2,0,0,2.8488292296701925e-4,6,1.0199732429654365,0,2014-04-01,-2,1372112,4
El Salvador,201404,0,0,0,0,2,11226,5613,10055,1,2,0,0,2.5622774132134412e-12,7,0.008344959905262829,0,2014-04-01,-2,11226,4
Paraguay,201404,0,0,0,0,1,5785,5785,5785,1,1,0,0,0,10,0.0043003378809857,0,2014-04-01,-1,5785,4
Montenegro,201404,0,0,0,0,4,141839,35459.75,68248,1,4,0,2,8.880819984108806e-5,11,0.1054374459293225,0,2014-04-01,-4,141839,4
Barbados,201404,0,0,0,0,1,699,699,699,1,1,0,0,0,17,5.196086739514267e-4,0,2014-04-01,-1,699,4
Malta,201404,0,0,0,0,2,9144,4572,7998,1,2,0,1,3.8693367274082624e-5,2,0.00679728428413712,0,2014-04-01,-2,9144,4
Bosnia Herzegovina,201404,0,0,0,0,7,335841,47977.2857142857,187735,1,7,0,8,0.0032744902348308016,11,0.24965078207227628,0,2014-04-01,-7,335841,4
Rep. of Moldova,201404,0,0,0,0,4,398245,99561.25,279436,1,4,0,2,1.2182357770615787e-4,6,0.29603942254332755,0,2014-04-01,-4,398245,4
Antigua and Barbuda,201404,0,0,0,0,2,2512,1256,2493,1,2,0,0,3.7931897661157575e-10,19,0.0018673204420114223,0,2014-04-01,-2,2512,4
Switzerland,201404,0,0,0,0,10,2530971,253097.1,1970493,1,10,0,19,0.04596306188923462,14,1.8814227254928708,0,2014-04-01,-10,2530971,4
Singapore,201404,0,0,0,0,8,911075,113884.375,795578,1,8,0,8,2.440803381165279e-5,16,0.6772567562522119,0,2014-04-01,-8,911075,4
Ethiopia,201404,0,0,0,0,1,414,414,414,1,1,0,0,4.4242234337201554e-7,3,3.077510601085704e-4,0,2014-04-01,-1,414,4
Zambia,201404,0,0,0,0,1,5,5,5,1,1,0,0,0,20,3.71680024285713e-6,0,2014-04-01,-1,5,4
Qatar,201404,0,0,0,0,16,225365,14085.3125,147860,1,16,0,9,1.5510431180400954e-4,9,0.16752733734629943,0,2014-04-01,-16,225365,4
Bermuda,201404,0,0,0,0,2,10943,5471.5,10768,1,2,0,0,1.5247867993891823e-6,8,0.008134589011517115,0,2014-04-01,-2,10943,4
Fiji,201404,0,0,0,0,1,171,171,171,1,1,0,0,3.164819605919142e-15,15,1.2711456830571385e-4,0,2014-04-01,-1,171,4
Mozambique,201404,0,0,0,0,1,12010,12010,12010,1,1,0,0,0,20,0.008927754183342827,0,2014-04-01,-1,12010,4
Aruba,201404,0,0,0,0,2,37875,18937.5,20178,1,2,0,0,3.0701565933683092e-9,8,0.028154761839642762,0,2014-04-01,-2,37875,4
"China, Hong Kong SAR",201404,0,0,0,0,12,337961,28163.4166666667,272945,1,12,0,10,5.516039430380946e-5,15,0.2512267053752477,0,2014-04-01,-12,337961,4
Norway,201404,0,0,0,0,7,551178,78739.7142857143,346439,1,7,0,14,0.012180283462784238,4,0.40972370485150145,0,2014-04-01,-7,551178,4
Cyprus,201404,0,0,0,0,2,21601,10800.5,20827,1,2,0,0,2.6973500658951286e-5,12,0.016057320409191375,0,2014-04-01,-2,21601,4
Montserrat,201404,0,0,0,0,1,304,304,304,1,1,0,0,0,19,2.2598145476571352e-4,0,2014-04-01,-1,304,4
Romania,201405,10,1945410,194541,1140215,10,101278,10127.8,48474,-0.9010323019434325,20,72,70,0.0032228400289938904,1,0.09584671551387326,1.8410825532479334,2014-05-01,0,2046688,5
Turkey,201405,14,2242978,160212.714285714,1588139,0,0,0,0,-1,14,0,29,0.0027780810144312044,1,0,2.1226927296142937,2014-05-01,14,2242978,5
Albania,201405,6,223362,37227,92073,0,0,0,0,-1,6,0,6,1.613771347599121e-5,1,0,0.2113836575624495,2014-05-01,6,223362,5
Czech Rep.,201405,8,609989,76248.625,559517,18,5027856,279325.333333333,1311346,0.7836091627208623,26,1181,109,0.06687188702064893,1,4.758224724784462,0.5772768236891728,2014-05-01,-10,5637845,5
Greece,201405,11,861871,78351.9090909091,284454,5,42191,8438.2,38803,-0.9066634810444416,16,102,41,0.004539857950383419,1,0.03992840275524622,0.8156510253624426,2014-05-01,6,904062,5
TFYR of Macedonia,201405,13,1784379,137259.923076923,923778,1,13483,13483,13483,-0.9850010734972985,14,0,33,0.0022873053412454008,1,0.012759940611717778,1.6886872408808395,2014-05-01,12,1797862,5
Poland,201405,16,982799,61424.9375,331128,9,559506,62167.3333333333,386878,-0.2744547933126068,25,403,91,0.006949686739129953,1,0.5295011000444833,0.9300939607843671,2014-05-01,7,1542305,5
Honduras,201405,3,21472,7157.33333333333,17187,0,0,0,0,-1,3,0,2,2.849327287160427e-8,2,0,0.02032051062929646,2014-05-01,3,21472,5
Belgium,201405,13,3008299,231407.615384615,1357652,5,4395537,879107.4,3580805,0.18736746735070847,18,71,56,0.20304046816294616,1,4.159815402848634,2.846971488710968,2014-05-01,8,7403836,5
France,201405,18,901484,50082.4444444444,288931,14,5213848,372417.714285714,2535720,0.7051725073961642,32,371,105,0.1024815269606175,1,4.93424244148361,0.8531396797755537,2014-05-01,4,6115332,5
Germany,201405,23,2308310,100361.304347826,495730,17,38127970,2242821.76470588,26102635,0.8858297548637016,40,672,145,0.9473563716230887,1,36.08326283804473,2.1845211387253776,2014-05-01,6,40436280,5
Indonesia,201405,3,2975,991.666666666667,2333,2,581,290.5,318,-0.6732283464566929,5,94,3,4.107646627796609e-9,3,5.498424308690966e-4,0.002815458230353808,2014-05-01,1,3556,5
Italy,201405,20,664346,33217.3,257392,10,976650,97665,568117,0.1903136875409812,30,996,100,0.014894194999761277,1,0.9242747161932929,0.6287187944546658,2014-05-01,10,1640996,5
Morocco,201405,4,17015,4253.75,9396,0,0,0,0,-1,4,0,3,3.2998460426115404e-5,1,0,0.01610252833259497,2014-05-01,4,17015,5
Portugal,201405,6,4553,758.833333333333,1687,3,63345,21115,63248,0.865887065892957,9,647,20,7.232830078793336e-4,1,0.059947966924962,0.004308834058084332,2014-05-01,3,67898,5
Spain,201405,30,18454247,615141.566666667,9589941,10,248586,24858.6,73559,-0.9734172892416887,40,182,148,0.3508585436082581,1,0.23525495786579217,17.46459213483431,2014-05-01,20,18702833,5
Egypt,201405,3,3856,1285.33333333333,1905,0,0,0,0,-1,3,0,3,1.1124489905303098e-4,1,0,0.003649212415544297,2014-05-01,3,3856,5
Netherlands,201405,36,49026053,1361834.80555556,26102635,9,2382790,264754.444444444,1035384,-0.9073003840992881,45,859,142,1,1,2.2550069635982353,46.39690904894521,2014-05-01,27,51408843,5
Bulgaria,201405,6,244042,40673.6666666667,177435,6,712176,118696,284454,0.4895682783633021,12,8,22,0.005513085130603608,1,0.6739837918186399,0.23095464116033748,2014-05-01,0,956218,5
Hungary,201405,8,90987,11373.375,86492,8,560793,70099.125,332069,0.7208045659578385,16,331,53,0.008984941405196617,1,0.530719081470522,0.0861075959681351,2014-05-01,0,651780,5
Dominica,201405,2,243,121.5,215,0,0,0,0,-1,2,0,0,8.387934547094312e-15,2,0,2.2996852100032783e-4,2014-05-01,2,243,5
Mexico,201405,3,1086402,362134,1085464,0,0,0,0,-1,3,0,0,8.711753832414077e-5,2,0,1.028140992394231,2014-05-01,3,1086402,5
United States of America,201405,8,1088157,136019.625,1041311,0,0,0,0,-1,8,0,2,8.357305214419721e-5,3,0,1.0298018761570114,2014-05-01,8,1088157,5
Iran,201405,4,687903,171975.75,564636,0,0,0,0,-1,4,0,2,2.1298799670292764e-4,4,0,0.651012491776496,2014-05-01,4,687903,5
Peru,201405,2,3426,1713,2662,0,0,0,0,-1,2,0,1,1.951774312019259e-9,2,0,0.0032422722343503014,2014-05-01,2,3426,5
Austria,201405,10,953428,95342.8,312471,11,965485,87771.3636363636,236354,0.0062832447328253025,21,65,69,0.022436012465807634,1,0.9137084670699651,0.9022980536637883,2014-05-01,-1,1918913,5
Estonia,201405,4,62597,15649.25,35356,5,235592,47118.4,179588,0.5801521853589502,9,105,16,8.785132033539072e-5,1,0.22295779341361827,0.059240080284187334,2014-05-01,-1,298189,5
Lithuania,201405,6,737207,122867.833333333,528159,7,964264,137752,492001,0.13344746986578085,13,46,23,0.017185449669692345,1,0.912552946229877,0.6976724422267024,2014-05-01,-1,1701471,5
India,201405,4,28207,7051.75,24893,0,0,0,0,-1,4,0,1,1.9080131049000806e-7,3,0,0.026694329513811718,2014-05-01,4,28207,5
United Kingdom,201405,6,72161,12026.8333333333,37921,15,14386124,959074.933333333,12708524,0.990018041558871,21,979,53,0.41472405571989057,1,13.614632342416956,0.06829118701195332,2014-05-01,-9,14458285,5
Chile,201405,2,1167,583.5,617,1,2662,2662,2662,0.39044136850352573,3,47,1,4.571450619212642e-8,2,0.002519243633345155,0.0011044167243102164,2014-05-01,1,3829,5
Costa Rica,201405,3,1489,496.333333333333,765,0,0,0,0,-1,3,0,0,1.744005852757291e-8,3,0,0.001409148673948511,2014-05-01,3,1489,5
Jordan,201405,5,95347,19069.4,52597,0,0,0,0,-1,5,0,8,6.091283868031842e-4,1,0,0.09023378013093933,2014-05-01,5,95347,5
Lebanon,201405,3,3021,1007,2383,0,0,0,0,-1,3,0,3,3.231111889683429e-5,5,0,0.0028589913660164216,2014-05-01,3,3021,5
Oman,201405,1,18967,18967,18967,0,0,0,0,-1,1,0,0,4.835971090216073e-8,5,0,0.017949847480712832,2014-05-01,1,18967,5
Saudi Arabia,201405,1,191301,191301,191301,0,0,0,0,-1,1,0,0,4.877556310991937e-7,5,0,0.1810420083781223,2014-05-01,1,191301,5
New Zealand,201405,2,770,385,601,1,24731,24731,24731,0.9396102113642603,3,1,1,7.499006079577111e-10,3,0.023404738653741184,7.287068360915738e-4,2014-05-01,1,25501,5
South Africa,201405,1,4450,4450,4450,0,0,0,0,-1,1,0,0,2.6033316409355407e-18,6,0,0.004211357689100654,2014-05-01,1,4450,5
Denmark,201405,4,54577,13644.25,43187,20,1255461,62773.05,596115,0.9166787528300706,24,398,91,0.027041314213840623,1,1.1881337833069654,0.05165017271866211,2014-05-01,-16,1310038,5
Australia,201405,5,39124,7824.8,24731,0,0,0,0,-1,5,0,5,1.4306190073393625e-8,3,0,0.037025878253567186,2014-05-01,5,39124,5
Rep. of Korea,201405,3,6228,2076,5900,0,0,0,0,-1,3,0,0,3.176151994743213e-8,3,0,0.005894008019712106,2014-05-01,3,6228,5
China,201405,5,4863490,972698,4536279,0,0,0,0,-1,5,0,2,0.001710834143723754,4,0,4.602673260081829,2014-05-01,5,4863490,5
Kyrgyzstan,201405,1,1928,1928,1928,0,0,0,0,-1,1,0,0,2.0424801059090683e-9,4,0,0.0018246062077721485,2014-05-01,1,1928,5
Russian Federation,201405,2,42982,21491,40900,20,17147150,857357.5,4536279,0.9949992239733819,22,20,42,0.012006755941285672,3,16.227591460373546,0.04067698341414029,2014-05-01,-18,17190132,5
Turkmenistan,201405,1,120495,120495,120495,0,0,0,0,-1,1,0,0,1.27649710064295e-7,4,0,0.11403315612318725,2014-05-01,1,120495,5
Uzbekistan,201405,2,1270631,635315.5,1267401,0,0,0,0,-1,2,0,1,2.5605555324995205e-6,4,0,1.2024902543504838,2014-05-01,2,1270631,5
Canada,201405,3,66758,22252.6666666667,45643,14,2344023,167430.214285714,1085464,0.9446171178551681,17,549,5,0.0025556314322314993,2,2.2183189403323107,0.06317793631662505,2014-05-01,-11,2410781,5
Dominican Rep.,201405,2,42803,21401.5,39999,0,0,0,0,-1,2,0,1,3.97293155388841e-5,2,0,0.04050758273406186,2014-05-01,2,42803,5
Ireland,201405,2,46225,23112.5,46200,7,829865,118552.142857143,741432,0.8944743119999087,9,0,18,0.025092749556980355,1,0.7853614266664076,0.04374606947835454,2014-05-01,-5,876090,5
Kenya,201405,1,3988,3988,3988,0,0,0,0,-1,1,0,0,5.193947197055887e-5,1,0,0.0037741335874457095,2014-05-01,1,3988,5
Venezuela,201405,1,13184,13184,13184,0,0,0,0,-1,1,0,0,2.5808438018879754e-11,3,0,0.012476975229910791,2014-05-01,1,13184,5
Ecuador,201405,2,4752,2376,4621,0,0,0,0,-1,2,0,1,1.4900430548112995e-5,1,0,0.0044971621884508555,2014-05-01,2,4752,5
Japan,201405,3,41701,13900.3333333333,37554,0,0,0,0,-1,3,0,2,4.99494281678827e-8,3,0,0.03946468022318795,2014-05-01,3,41701,5
Malaysia,201405,2,809217,404608.5,807857,9,288209,32023.2222222222,270206,-0.47475456203880717,11,5,15,8.317596937178887e-6,3,0.27275307600404725,0.7658207269889806,2014-05-01,-7,1097426,5
Thailand,201405,3,330079,110026.333333333,270206,0,0,0,0,-1,3,0,2,1.2631655638531048e-7,3,0,0.3123776931821696,2014-05-01,3,330079,5
Viet Nam,201405,2,8176,4088,5147,0,0,0,0,-1,2,0,1,7.118228558756467e-9,3,0,0.0077375416777723475,2014-05-01,2,8176,5
Croatia,201405,4,109736,27434,61667,9,447039,49671,180975,0.6058156346818733,13,267,36,0.0025093684450006428,1,0.42306542246693646,0.10385113424070772,2014-05-01,-5,556775,5
Slovenia,201405,3,11261,3753.66666666667,11102,9,452969,50329.8888888889,257392,0.9514852551536954,12,216,23,6.319726799567781e-4,1,0.428677411477356,0.010657100884710665,2014-05-01,-6,464230,5
Bosnia Herzegovina,201405,1,6404,6404,6404,5,54808,10961.6,42955,0.790759981702934,6,74,8,2.386287464680955e-5,1,0.051868784769489584,0.006060569582247323,2014-05-01,-4,61212,5
Serbia,201405,3,1909,636.333333333333,991,3,946081,315360.333333333,923778,0.995972531355816,6,108,7,6.825275091099754e-5,1,0.8953450548004575,0.0018066251299984602,2014-05-01,0,947990,5
Brazil,201405,1,7218,7218,7218,0,0,0,0,-1,1,0,0,2.6033316409355407e-18,7,0,0.006830916808972701,2014-05-01,1,7218,5
Guatemala,201405,2,3832,1916,3617,1,3930,3930,3930,0.012625611955681525,3,1,2,1.725871204391097e-8,2,0.0037192439816102403,0.0036264994751985854,2014-05-01,1,7762,5
Israel,201405,1,3846,3846,3846,0,0,0,0,-1,1,0,0,3.08667322282963e-7,2,0,0.0036397486904002504,2014-05-01,1,3846,5
Pakistan,201405,1,6,6,6,0,0,0,0,-1,1,0,0,4.815402816191953e-10,2,0,5.678235086427848e-6,2014-05-01,1,6,5
Sweden,201405,4,81611,20402.75,54342,5,88655,17731,43187,0.04137056135693562,9,0,20,8.594940454779696e-4,1,0.083900655264543475,0.07723440727307718,2014-05-01,-1,170266,5
Ukraine,201405,2,4351495,2175747.5,4225995,1,6,6,6,-0.9999972423308647,3,0,3,0.0016024595364328407,3,5.678235086427848e-6,4.118135264569225,2014-05-01,1,4351501,5
Armenia,201405,1,11526,11526,11526,0,0,0,0,-1,1,0,0,4.345977281349238e-6,3,0,0.010907889601027896,2014-05-01,1,11526,5
Belarus,201405,1,4454350,4454350,4454350,7,224700,32100,125500,-0.9039548626323719,8,0,9,0.002286246292331502,1,0.2126499039867229,4.215474409538314,2014-05-01,-6,4679050,5
Kazakhstan,201405,1,76205,76205,76205,7,1472615,210373.571428571,1267401,0.9015960537699668,8,6,4,3.3733985440386116e-5,4,1.3936423602999908,0.0721183174602057,2014-05-01,-6,1548820,5
Rep. of Moldova,201405,2,8240,4120,7470,2,157523,78761.5,155189,0.9005809499104143,4,2,4,2.384379767055489e-4,1,0.1490754375865623,0.007798109518694245,2014-05-01,0,165763,5
Slovakia,201405,3,77475,25825,42737,15,928089,61872.6,333987,0.8459073713856105,18,55,66,0.014229993372720347,1,0.8783179205212891,0.07332021055349959,2014-05-01,-12,1005564,5
Azerbaijan,201405,1,48350,48350,48350,1,95700,95700,95700,0.3287053106560222,2,0,1,1.8870886240084104e-5,4,0.09056784962852417,0.04575711107146441,2014-05-01,0,144050,5
Latvia,201405,2,203885,101942.5,179588,5,234293,46858.6,129145,0.06939645532180985,7,0,10,0.0012534398404215517,1,0.22172845551740664,0.19295116009939028,2014-05-01,-3,438178,5
Finland,201405,1,59,59,59,5,400018,80003.6,312829,0.9997050567765705,6,50,10,0.010616394612838576,1,0.3785660404671158,5.5835978349873835e-5,2014-05-01,-4,400077,5
Luxembourg,201405,3,899,299.666666666667,449,10,175737,17573.7,116816,0.9898208745669059,13,708,29,0.0016274291894203406,1,0.16631266656392846,8.507888904497725e-4,2014-05-01,-7,176636,5
Cyprus,201405,1,4654,4654,4654,1,9577,9577,9577,0.34593493078490617,2,0,1,4.6444884084183975e-6,1,0.00906340957045325,0.004404417682039201,2014-05-01,0,14231,5
Sri Lanka,201405,1,2354,2354,2354,0,0,0,0,-1,1,0,0,7.003304222579172e-5,1,0,0.002227760898908526,2014-05-01,1,2354,5
Suriname,201405,1,313,313,313,0,0,0,0,-1,1,0,0,9.829410917831807e-6,1,0,2.9621459700865274e-4,2014-05-01,1,313,5
Malta,201405,0,0,0,0,2,7892,3946,7579,1,2,0,1,1.3374377096564447e-5,1,0.007468771883681429,0,2014-05-01,-2,7892,5
Antigua and Barbuda,201405,0,0,0,0,3,3654,1218,3380,1,3,0,0,9.543881617665601e-9,2,0.0034580451676345593,0,2014-05-01,-3,3654,5
Switzerland,201405,0,0,0,0,9,769038,85448.6666666667,422257,1,9,0,22,0.013312920060302923,1,0.7277964257327165,0,2014-05-01,-9,769038,5
Niger,201405,0,0,0,0,1,13,13,13,1,1,0,0,4.0825029371050846e-7,1,1.2302842687260338e-5,0,2014-05-01,-1,13,5
Qatar,201405,0,0,0,0,17,276943,16290.7647058824,191301,1,17,0,17,8.11898797531229e-5,5,0.2620912432567646,0,2014-05-01,-17,276943,5
Bermuda,201405,0,0,0,0,1,18567,18567,18567,1,1,0,0,4.872941011439993e-8,3,0.017571298474950977,0,2014-05-01,-1,18567,5
Fiji,201405,0,0,0,0,1,169,169,169,1,1,0,0,3.980494078990442e-15,3,1.5993695493438437e-4,0,2014-05-01,-1,169,5
Mozambique,201405,0,0,0,0,1,4450,4450,4450,1,1,0,0,0,6,0.004211357689100654,0,2014-05-01,-1,4450,5
Zambia,201405,0,0,0,0,1,14,14,14,1,1,0,0,3.950266883820815e-9,1,1.3249215201664978e-5,0,2014-05-01,-1,14,5
Aruba,201405,0,0,0,0,2,36935,18467.5,23751,1,2,0,0,6.233491774870298e-8,3,0.03495426881953543,0,2014-05-01,-2,36935,5
Singapore,201405,0,0,0,0,8,903225,112903.125,807857,1,8,0,8,2.9480904609507194e-5,3,0.8547873143231322,0,2014-05-01,-8,903225,5
"China, Hong Kong SAR",201405,0,0,0,0,11,322668,29333.4545454545,261507,1,11,0,9,3.914382136765984e-5,3,0.30536412647791683,0,2014-05-01,-11,322668,5
Montserrat,201405,0,0,0,0,1,215,215,215,1,1,0,0,0,2,2.0347009059699787e-4,0,2014-05-01,-1,215,5
Cabo Verde,201405,0,0,0,0,2,1846,923,1836,1,2,0,1,2.0229854676388695e-5,1,0.0017470036615909678,0,2014-05-01,-2,1846,5
Paraguay,201405,0,0,0,0,1,7218,7218,7218,1,1,0,0,0,7,0.006830916808972701,0,2014-05-01,-1,7218,5
El Salvador,201405,0,0,0,0,2,20804,10402,17187,1,2,0,1,1.7339287334583175e-11,2,0.019688333789674158,0,2014-05-01,-2,20804,5
Georgia,201405,0,0,0,0,1,218521,218521,218521,1,1,0,0,1.9064316495098605e-5,1,0.20680226822021663,0,2014-05-01,-1,218521,5
Montenegro,201405,0,0,0,0,4,108381,27095.25,92073,1,4,0,4,4.919553602844878e-6,1,0.10256879948368942,0,2014-05-01,-4,108381,5
Norway,201405,0,0,0,0,6,402529,67088.1666666667,334118,1,6,0,10,0.011095174217158605,1,0.3809423818507859,0,2014-05-01,-6,402529,5
Panama,201405,0,0,0,0,2,767,383.5,531,1,2,0,0,6.196768619547625e-10,3,7.258677185483599e-4,0,2014-05-01,-2,767,5
Iceland,201405,0,0,0,0,2,871,435.5,819,1,2,0,1,2.7266802571697156e-5,1,8.242904600464425e-4,0,2014-05-01,-2,871,5
Ethiopia,201405,0,0,0,0,1,20,20,20,1,1,0,0,1.6051342816095335e-9,2,1.8927450288092827e-5,0,2014-05-01,-1,20,5
Germany,201406,26,2940753,113105.884615385,705572,19,37655890,1981888.94736842,26968241,0.8551233411097563,45,575,156,0.9074980829299901,1,39.758241133814465,3.104937020184314,2014-06-01,7,40596643,6
Italy,201406,20,492869,24643.45,171462,9,1025808,113978.666666667,417129,0.350923204868448,29,1149,93,0.012603447183201763,1,1.0830794816161815,0.5203861746298388,2014-06-01,11,1518677,6
Belgium,201406,16,3546832,221677,1494101,7,5048806,721258,4016640,0.17473676764889354,23,393,67,0.22307464290925716,1,5.3306838952909965,3.744853777646191,2014-06-01,9,8595638,6
Canada,201406,2,40937,20468.5,20668,10,2737934,273793.4,1854377,0.970536955475803,12,135,5,9.369682907538133e-4,2,2.8907945126371777,0.04322253749134499,2014-06-01,-8,2778871,6
United States of America,201406,7,1896381,270911.571428571,1854377,0,0,0,0,-1,7,0,0,5.376747917943475e-5,2,0,2.0022570992103548,2014-06-01,7,1896381,6
Venezuela,201406,1,15955,15955,15955,0,0,0,0,-1,1,0,0,2.261679590855055e-11,2,0,0.016845777308410713,2014-06-01,1,15955,6
Dominica,201406,2,396,198,223,0,0,0,0,-1,2,0,0,1.7534289623883095e-14,2,0,4.181089197198773e-4,2014-06-01,2,396,6
Hungary,201406,8,1012532,126566.5,385309,6,252411,42068.5,122892,-0.6009132427310954,14,572,37,0.009362081702418978,1,0.26650325892781296,1.069062274499512,2014-06-01,2,1264943,6
Croatia,201406,4,159198,39799.5,135998,9,474647,52738.5555555556,171462,0.49767529916619996,13,193,32,0.0017525735275714966,1,0.5011468293390924,0.16808612071102277,2014-06-01,-5,633845,6
Portugal,201406,6,8191,1365.16666666667,3656,2,22633,11316.5,22579,0.46853101479366727,8,49,14,1.9061543543460338e-4,1,0.023896614090959552,0.00864830848844827,2014-06-01,4,30824,6
Spain,201406,28,12547198,448114.214285714,6434929,12,216519,18043.25,96761,-0.9660727357085714,40,198,141,0.2229908685042218,1,0.22860738684047502,13.24771565982678,2014-06-01,16,12763717,6
Azerbaijan,201406,1,7899,7899,7899,0,0,0,0,-1,1,0,0,2.482006272079368e-7,3,0,0.008340005951685128,2014-06-01,1,7899,6
Armenia,201406,2,17268,8634,11595,0,0,0,0,-1,2,0,0,3.6435662499948294e-7,3,0,0.018232082893239496,2014-06-01,2,17268,6
Belarus,201406,1,1988989,1988989,1988989,2,9900,4950,9400,-0.9900944974933575,3,2,1,6.253181395362648e-5,3,0.010452722992996932,2.1000354599109063,2014-06-01,-1,1998889,6
China,201406,4,1809428,452357,1489394,0,0,0,0,-1,4,0,1,4.709096391915101e-5,3,0,1.910449460583076,2014-06-01,4,1809428,6
Czech Rep.,201406,6,297404,49567.3333333333,223324,16,4312177,269511.0625,1137933,0.8709626753494515,22,533,88,0.051146294168908396,1,4.552928452300256,0.31400824535447064,2014-06-01,-10,4609581,6
Japan,201406,4,58767,14691.75,53802,0,0,0,0,-1,4,0,2,6.491445447426424e-8,4,0,0.062047997184793,2014-06-01,4,58767,6
Kazakhstan,201406,1,34574,34574,34574,8,1561260,195157.5,1463220,0.9566696786758523,9,10,3,2.234913004801555e-6,3,1.6484260909137767,0.03650428734948242,2014-06-01,-7,1595834,6
Lithuania,201406,6,466370,77728.3333333333,296378,6,469997,78332.8333333333,228647,0.003873481231183927,12,120,25,0.006004100346792224,1,0.4962372170241999,0.49240771941858374,2014-06-01,0,936367,6
Netherlands,201406,31,50770071,1637744.22580645,26968241,5,2360903,472180.6,1374532,-0.9111289395899274,36,110,125,1,1,2.4927136436702457,53.604594797756235,2014-06-01,26,53130974,6
Poland,201406,16,539617,33726.0625,228647,10,1267351,126735.1,396465,0.4027376245733184,26,285,102,0.01300571759402688,1,1.3381079735250156,0.5697441437688915,2014-06-01,6,1806968,6
Ukraine,201406,2,2032204,1016102,2022804,1,19,19,19,-0.9999813012646742,3,0,2,6.370944275217754e-5,3,2.0060781501711283e-5,2.145663179521246,2014-06-01,1,2032223,6
Uzbekistan,201406,2,1477151,738575.5,1463220,0,0,0,0,-1,2,0,1,5.389298296683268e-7,3,0,1.5596212345281222,2014-06-01,2,1477151,6
Brazil,201406,2,16779,8389.5,10787,0,0,0,0,-1,2,0,0,1.3649641490739895e-8,4,0,0.01771578172722177,2014-06-01,2,16779,6
Latvia,201406,3,230118,76706,222308,6,380062,63343.6666666667,296378,0.24573732341276344,9,0,15,0.0018293274476453038,1,0.40128109153175756,0.24296562724267354,2014-06-01,-3,610180,6
Estonia,201406,4,34326,8581.5,30014,5,307011,61402.2,222308,0.7988732542912137,9,130,16,1.7728804405954892e-4,1,0.32415160998009906,0.03624244135935482,2014-06-01,-1,341337,6
Peru,201406,1,4106,4106,4106,0,0,0,0,-1,1,0,0,1.2643704661005981e-17,5,0,0.004335240465580343,2014-06-01,1,4106,6
Guatemala,201406,1,7885,7885,7885,1,1715,1715,1715,-0.6427083333333333,2,1,1,2.5287409322011962e-17,6,0.0018107494881807816,0.008325224323210182,2014-06-01,0,9600,6
Honduras,201406,2,20681,10340.5,18966,0,0,0,0,-1,2,0,1,1.5172445593207176e-17,6,0,0.021835632749310056,2014-06-01,2,20681,6
Nicaragua,201406,1,654,654,654,0,0,0,0,-1,1,0,0,1.5172445593207176e-17,6,0,6.905132159010094e-4,2014-06-01,1,654,6
Turkey,201406,10,420451,42045.1,190071,0,0,0,0,-1,10,0,18,0.0034983040951183436,1,0,0.443925033851369,2014-06-01,10,420451,6
Albania,201406,5,31852,6370.4,13984,0,0,0,0,-1,5,0,6,4.1392893559105593e-5,1,0,0.03363031644171094,2014-06-01,5,31852,6
Serbia,201406,5,332590,66518,291576,3,227941,75980.3333333333,217267,-0.18669618629478119,8,0,16,3.601657505309496e-4,1,0.24066708401481957,0.35115870103442925,2014-06-01,2,560531,6
TFYR of Macedonia,201406,13,1650777,126982.846153846,376770,1,241,241,241,-0.9997080589066867,14,1,35,0.0030893063762215374,1,2.5445517589012734e-4,1.7429408792131813,2014-06-01,12,1651018,6
Australia,201406,6,42960,7160,30389,0,0,0,0,-1,6,0,5,1.6170961908537774e-8,4,0,0.04535848280597456,2014-06-01,6,42960,6
Colombia,201406,1,104,104,104,0,0,0,0,-1,1,0,0,3.0153560907242094e-9,2,0,1.0980638295673544e-4,2014-06-01,1,104,6
Dominican Rep.,201406,2,5453,2726.5,2875,0,0,0,0,-1,2,0,1,3.383418370970372e-5,2,0,0.005757444290991138,2014-06-01,2,5453,6
Israel,201406,2,2746,1373,2720,0,0,0,0,-1,2,0,0,2.583381443725173e-7,2,0,0.0028993108422999568,2014-06-01,2,2746,6
Jordan,201406,6,155843,25973.8333333333,93120,0,0,0,0,-1,6,0,7,5.836136335239744e-4,2,0,0.16454380903006272,2014-06-01,6,155843,6
Mexico,201406,1,756250,756250,756250,0,0,0,0,-1,1,0,0,2.1926567655089743e-5,2,0,0.7984718952983767,2014-06-01,1,756250,6
India,201406,5,26709,5341.8,22531,0,0,0,0,-1,5,0,1,3.2587351874827367e-7,4,0,0.028200179638379296,2014-06-01,5,26709,6
Indonesia,201406,3,547,182.333333333333,478,2,745,372.5,477,0.15325077399380804,5,91,3,2.7325954633703055e-9,4,7.865938009881529e-4,5.775393411282143e-4,2014-06-01,1,1292,6
Viet Nam,201406,1,984,984,984,0,0,0,0,-1,1,0,0,4.408577860678845e-11,4,0,0.0010389373156675739,2014-06-01,1,984,6
Thailand,201406,5,270341,54068.2,213906,2,588,294,571,-0.9956593793946016,7,162,4,1.620055003846636e-5,1,6.208283959476965e-4,0.2854343016817963,2014-06-01,3,270929,6
Trinidad and Tobago,201406,1,323,323,323,0,0,0,0,-1,1,0,0,1.2643704661005981e-17,7,0,3.410332855290918e-4,2014-06-01,1,323,6
Sweden,201406,4,120728,30182,91818,7,122596,17513.7142857143,70718,0.007677006789301507,11,0,27,5.094252258658796e-4,1,0.12944060889388403,0.1274683173230842,2014-06-01,-3,243324,6
United Kingdom,201406,7,131776,18825.1428571429,68763,14,14450657,1032189.78571429,13471134,0.9819267470661446,21,700,56,0.4230786670956111,1,15.257445928061824,0.13913313385102663,2014-06-01,-7,14582433,6
Austria,201406,9,1386528,154058.666666667,728626,10,1741326,174132.6,376770,0.11343176503762643,19,195,60,0.037386128213229695,1,1.8385452846973105,1.4639386975791968,2014-06-01,-1,3127854,6
France,201406,17,1254049,73767.5882352941,666016,14,6369599,454971.357142857,2852337,0.6710107811903173,31,657,93,0.12746846412441865,1,6.7252175680273,1.324063314812607,2014-06-01,3,7623648,6
Greece,201406,8,641828,80228.5,543449,1,5089,5089,5089,-0.9842669152302382,9,46,16,0.015593681894153557,1,0.0053731219506425645,0.67766164577265,2014-06-01,7,646917,6
Romania,201406,11,2482914,225719.454545455,1137933,7,100791,14398.7142857143,83879,-0.9219794829518075,18,188,41,0.02128037919316788,1,0.10641822254415695,2.621536591659998,2014-06-01,4,2583705,6
Slovakia,201406,3,178586,59528.6666666667,133714,13,718762,55289.3846153846,237284,0.6019693585988937,16,18,47,0.009163034293027901,1,0.758890917564895,0.1885565644876111,2014-06-01,-10,897348,6
Denmark,201406,4,94455,23613.75,70718,21,994174,47341.619047619,607433,0.8264698074366933,25,495,94,0.022869972087059227,1,1.0496793362464376,0.0997284798286389,2014-06-01,-17,1088629,6
Ireland,201406,2,67110,33555,67085,9,883568,98174.2222222222,767338,0.8588165498728276,11,42,26,0.025644467614497277,4,0.9328981363107387,0.07085679192525496,2014-06-01,-7,950678,6
Russian Federation,201406,2,3694,1847,3194,14,5951379,425098.5,2022804,0.9987593770890801,16,65,18,0.0010154309319415978,3,6.283648092256473,0.0039002382561748148,2014-06-01,-12,5955073,6
Kyrgyzstan,201406,1,15480,15480,15480,0,0,0,0,-1,1,0,0,1.070562324263694e-9,3,0,0.01634425777086793,2014-06-01,1,15480,6
Iran,201406,2,8601,4300.5,8552,0,0,0,0,-1,2,0,0,7.030581691799103e-10,3,0,0.009081199036643091,2014-06-01,2,8601,6
Turkmenistan,201406,1,47738,47738,47738,0,0,0,0,-1,1,0,0,3.3014537331181788e-9,3,0,0.05040324143835227,2014-06-01,1,47738,6
Lebanon,201406,1,538,538,538,0,0,0,0,-1,1,0,0,2.1220978275573606e-6,1,0,5.680368656800353e-4,2014-06-01,1,538,6
Morocco,201406,2,1321,660.5,1260,0,0,0,0,-1,2,0,0,3.6061568783329236e-7,1,0,0.0013947522296716107,2014-06-01,2,1321,6
Egypt,201406,2,2402,1201,2229,0,0,0,0,-1,2,0,1,6.26040007683825e-5,1,0,0.0025361051140584475,2014-06-01,2,2402,6
Luxembourg,201406,3,666,222,394,10,208641,20864.1,144468,0.9936361421261591,13,795,26,0.00177520964870502,1,0.2202895533315023,7.031831831652481e-4,2014-06-01,-7,209307,6
Finland,201406,1,59,59,59,6,374474,62412.3333333333,346881,0.9996849409798335,7,44,13,0.010827159655362581,1,0.39538111010904375,6.22940057158403e-5,2014-06-01,-5,374533,6
Cyprus,201406,1,4200,4200,4200,2,11608,5804,8952,0.4686234817813765,3,99,1,4.395057200242668e-5,1,0.012256081666940241,0.004434488542483547,2014-06-01,-1,15808,6
Ecuador,201406,2,239,119.5,217,0,0,0,0,-1,2,0,1,1.5062172579684696e-6,1,0,2.5234351467942086e-4,2014-06-01,2,239,6
Bosnia Herzegovina,201406,1,20086,20086,20086,5,29464,5892.8,27816,0.18926337033299698,6,0,7,4.355874979880798e-6,1,0.031108992956127433,0.021207413539124885,2014-06-01,-4,49550,6
Slovenia,201406,2,379,189.5,307,11,354740,32249.0909090909,135998,0.997865504239424,13,843,37,3.729136849929665e-4,1,0.3745453489430032,4.001597994288724e-4,2014-06-01,-9,355119,6
Bulgaria,201406,2,73130,36565,73071,4,324876,81219,196690,0.6325181027421697,6,0,6,0.002146693381112137,1,0.34301402374473444,0.07721289216948138,2014-06-01,-2,398006,6
Sri Lanka,201406,1,1346,1346,1346,0,0,0,0,-1,1,0,0,3.7798202576394515e-5,1,0,0.0014211479948054414,2014-06-01,1,1346,6
Rep. of Moldova,201406,1,10942,10942,10942,1,38302,38302,38302,0.5556006823166274,2,0,1,3.324939634075281e-4,1,0.04044042384623924,0.011552898483774993,2014-06-01,0,49244,6
Pakistan,201406,1,6,6,6,0,0,0,0,-1,1,0,0,6.047129763904197e-10,1,0,6.334983632119352e-6,2014-06-01,1,6,6
Malaysia,201406,2,793358,396679,792382,6,216477,36079.5,213906,-0.571262632014141,8,5,9,1.4478480067158206e-6,4,0.22856304195505017,0.8376516574018242,2014-06-01,-4,1009835,6
Kenya,201406,1,3847,3847,3847,0,0,0,0,-1,1,0,0,8.763378661979064e-9,4,0,0.0040617803387938585,2014-06-01,1,3847,6
Oman,201406,1,17702,17702,17702,0,0,0,0,-1,1,0,0,4.032475408861148e-8,4,0,0.018690313375962796,2014-06-01,1,17702,6
Saudi Arabia,201406,1,207150,207150,207150,0,0,0,0,-1,1,0,0,4.718829967068549e-7,4,0,0.21871530989892066,2014-06-01,1,207150,6
South Africa,201406,2,12714,6357,12440,0,0,0,0,-1,2,0,0,6.241658925643099e-10,4,0,0.013423830316460907,2014-06-01,2,12714,6
Rep. of Korea,201406,2,7256,3628,6988,0,0,0,0,-1,2,0,0,6.79335603413534e-9,4,0,0.007661106872443003,2014-06-01,2,7256,6
New Zealand,201406,2,750,375,569,1,30389,30389,30389,0.9518288962394424,3,1,1,1.9116446962933416e-10,4,0.032085636266079166,7.91872954014919e-4,2014-06-01,1,31139,6
Aruba,201406,0,0,0,0,2,43488,21744,27533,1,2,0,0,4.580930348305217e-8,2,0.04591596136560107,0,2014-06-01,-2,43488,6
Montserrat,201406,0,0,0,0,1,223,223,223,1,1,0,0,1.0114963728804784e-17,2,2.3545022499376928e-4,0,2014-06-01,-1,223,6
Cabo Verde,201406,0,0,0,0,2,1212,606,1167,1,2,0,1,8.0529058594532208e-06,1,0.0012796666936881092,0,2014-06-01,-2,1212,6
Panama,201406,0,0,0,0,1,540,540,540,1,1,0,0,8.98449790887372e-10,2,5.701485268907417e-4,0,2014-06-01,-1,540,6
Iceland,201406,0,0,0,0,1,847,847,847,1,1,0,0,2.6209804553736285e-5,1,8.942885227341819e-4,0,2014-06-01,-1,847,6
Paraguay,201406,0,0,0,0,1,10787,10787,10787,1,1,0,0,4.556204491930285e-12,4,0.011389244739945242,0,2014-06-01,-1,10787,6
Georgia,201406,0,0,0,0,2,6783,3391.5,5673,1,2,0,0,1.2022423551545392e-7,3,0.007161698996110928,0,2014-06-01,-2,6783,6
Chile,201406,0,0,0,0,1,4106,4106,4106,1,1,0,0,1.0114963728804784e-17,5,0.004335240465580343,0,2014-06-01,-1,4106,6
El Salvador,201406,0,0,0,0,3,27505,9168.33333333333,18966,1,3,0,1,2.022992745760957e-17,6,0.029040620800240464,0,2014-06-01,-3,27505,6
Montenegro,201406,0,0,0,0,4,16717,4179.25,13984,1,4,0,4,3.7480438444234984e-7,1,0.01765032022968987,0,2014-06-01,-4,16717,6
Barbados,201406,0,0,0,0,1,323,323,323,1,1,0,0,1.2643704661005981e-17,7,3.410332855290918e-4,0,2014-06-01,-1,323,6
Norway,201406,0,0,0,0,7,329921,47131.5714285714,232877,1,7,0,12,0.00841110994901844,1,0.3483406891487415,0,2014-06-01,-7,329921,6
Malta,201406,0,0,0,0,2,8944,4472,8210,1,2,0,1,2.591503867509377e-5,1,0.009443348934279248,0,2014-06-01,-2,8944,6
Switzerland,201406,0,0,0,0,11,437448,39768,139943,1,11,0,28,0.0032569992597920806,1,0.46187098665055776,0,2014-06-01,-11,437448,6
Singapore,201406,0,0,0,0,9,883268,98140.8888888889,792382,1,9,0,7,5.463570532392867e-5,4,0.9325813871291327,0,2014-06-01,-9,883268,6
Antigua and Barbuda,201406,0,0,0,0,2,2139,1069.5,1966,1,2,0,0,3.271022750946728e-9,2,0.0022584216648505492,0,2014-06-01,-2,2139,6
Qatar,201406,0,0,0,0,16,338834,21177.125,207150,1,16,0,16,7.361545810385007e-5,4,0.35775130733425475,0,2014-06-01,-16,338834,6
Bermuda,201406,0,0,0,0,2,10938,5469,10833,1,2,0,0,1.3926696664673605e-6,2,0.01154867516135358,0,2014-06-01,-2,10938,6
Mozambique,201406,0,0,0,0,1,12440,12440,12440,1,1,0,0,2.4027843463682545e-13,4,0.013134532730594124,0,2014-06-01,-1,12440,6
"China, Hong Kong SAR",201406,0,0,0,0,10,366539,36653.9,296087,1,10,0,5,3.141591101141808e-5,1,0.3870030942555659,0,2014-06-01,-10,366539,6
Fiji,201406,0,0,0,0,1,569,569,569,1,1,0,0,3.3733404035563956e-15,4,6.007676144459853e-4,0,2014-06-01,-1,569,6
Estonia,201407,4,22253,5563.25,12149,4,815323,203830.75,492746,0.9468633294172708,8,0,11,0.012032018022852501,1,0.7928588326100312,0.021639874751565973,2014-07-01,0,837576,7
Finland,201407,2,18228,9114,18213,4,484522,121130.5,391694,0.9274868224763799,6,40,12,0.01181212830469346,1,0.47117221922339675,0.017725773467467062,2014-07-01,-2,502750,7
Germany,201407,25,7566529,302661.16,1511410,18,39042158,2169008.77777778,27852092,0.6753167923395911,43,604,155,0.8632422138209872,1,37.966449878706214,7.358052391322147,2014-07-01,7,46608687,7
Lithuania,201407,6,269070,44845,103434,4,623302,155825.5,461455,0.39695552975664855,10,45,16,0.00436087001771243,1,0.6061284866040791,0.2616564552826071,2014-07-01,2,892372,7
Netherlands,201407,30,58218361,1940612.03333333,27852092,8,3500184,437523,2167919,-0.8865759392091955,38,433,130,0.9999999999999999,1,3.403745264343468,56.6143010057724,2014-07-01,22,61718545,7
Poland,201407,18,1546506,85917,461455,11,2062462,187496.545454545,882198,0.1429649694871221,29,617,113,0.021765194968514884,1,2.005636065243529,1.5038959305507251,2014-07-01,7,3608968,7
Azerbaijan,201407,1,13038,13038,13038,0,0,0,0,-1,1,0,0,7.69447906275227e-8,2,0,0.012678770817908469,2014-07-01,1,13038,7
Armenia,201407,1,9516,9516,9516,0,0,0,0,-1,1,0,0,5.6159428406890717e-8,2,0,0.009253810638381422,2014-07-01,1,9516,7
Czech Rep.,201407,7,379701,54243,213855,18,6465621,359201.166666667,1511410,0.8890626328461977,25,496,98,0.074467930578187,1,6.287477132570653,0.36923929731022115,2014-07-01,-11,6845322,7
Slovakia,201407,4,349790,87447.5,303051,13,1416200,108938.461538462,419959,0.6038595915039157,17,218,50,0.015503440080873829,1,1.3771801834884165,0.34015241941986524,2014-07-01,-9,1765990,7
Ukraine,201407,3,561711,187237,488401,1,24,24,24,-0.9999145504552859,4,46,3,1.301025170337077e-4,2,2.33387405759935e-5,0.5462344711534118,2014-07-01,2,561735,7
Uzbekistan,201407,2,35053,17526.5,30907,0,0,0,0,-1,2,0,1,2.4474315083130046e-8,2,0,0.034087203058762505,2014-07-01,2,35053,7
Spain,201407,25,9005916,360236.64,5799038,13,358134,27548.7692307692,142931,-0.9235087382062249,38,673,140,0.164223493371329,1,0.348266521560119,8.757780715549545,2014-07-01,12,9364050,7
Brazil,201407,1,12973,12973,12973,0,0,0,0,-1,1,0,0,0,3,0,0.012615561728848486,2014-07-01,1,12973,7
Latvia,201407,3,120994,40331.3333333333,105020,6,255708,42618,103434,0.35761424149593046,9,88,16,0.00231840916644045,1,0.24866261146692276,0.11766031571882322,2014-07-01,-3,376702,7
Austria,201407,10,1606001,160600.1,754218,11,2640023,240002.090909091,915710,0.24352712090181308,21,43,85,0.0364415427391956,4,2.567283829652337,1.561751695991089,2014-07-01,-1,4246024,7
Belgium,201407,12,5209984,434165.333333333,2167919,7,6367053,909579,5803750,0.09994517595478014,19,116,72,0.2865337009315849,1,6.191624925025048,5.066436040878205,2014-07-01,5,11577037,7
Bulgaria,201407,5,461764,92352.8,406601,4,145559,36389.75,87381,-0.5206537542625588,9,0,11,9.017313712451337e-4,1,0.1415484891458766,0.44904125847221094,2014-07-01,1,607323,7
France,201407,16,497466,31091.625,180427,15,5313406,354227.066666667,2965694,0.8287809471624913,31,631,122,0.10733188823420119,1,5.167008508705305,0.4837595799740493,2014-07-01,1,5810872,7
Greece,201407,7,138790,19827.1428571429,60871,3,46338,15446,27701,-0.49939501318007,10,50,17,0.0018563424315666886,1,0.04506127336709945,0.13496599185592242,2014-07-01,4,185128,7
Hungary,201407,10,3634306,363430.6,1349374,5,488760,97752,282616,-0.7629142972729517,15,398,55,0.02768307244198727,1,0.4752934518301076,3.5341718711573598,2014-07-01,5,4123066,7
Ireland,201407,2,90094,45047,90072,11,675475,61406.8181818182,611039,0.7646351929088038,13,44,32,0.018744159424818725,1,0.6568639912737171,0.0876116872272316,2014-07-01,-9,765569,7
Italy,201407,18,132472,7359.55555555556,26916,7,1414359,202051.285714286,754218,0.8287181986913891,25,864,93,0.014989100846053163,4,1.3753899075967329,0.1288220683992921,2014-07-01,11,1546831,7
Jordan,201407,7,125954,17993.4285714286,80684,0,0,0,0,-1,7,0,11,5.680070132075462e-4,1,0,0.12248365543786188,2014-07-01,7,125954,7
Luxembourg,201407,4,2326,581.5,1064,9,186593,20732.5555555556,130567,0.9753756901105765,13,541,26,0.001576030113611735,1,0.18145190084568147,0.00226191294082337,2014-07-01,-5,188919,7
Portugal,201407,7,7085,1012.14285714286,3859,3,60427,20142.3333333333,42349,0.7901113876051665,10,595,19,7.211282689495458e-4,1,0.058762086532731635,0.006889790707538081,2014-07-01,4,67512,7
Sweden,201407,6,103148,17191.3333333333,73209,8,1419173,177396.625,1177804,0.864485873872856,14,438,41,0.03481034837434335,1,1.3800712699772677,0.10030601720552407,2014-07-01,-2,1522321,7
Turkey,201407,9,470404,52267.1111111111,233155,0,0,0,0,-1,9,0,19,0.006482192652778411,1,0,0.4574432050795686,2014-07-01,9,470404,7
United Kingdom,201407,6,172914,28819,93556,13,17618818,1355293.69230769,16860420,0.9805624320330365,19,378,63,0.47664335011587144,1,17.13337593990186,0.16814979116488918,2014-07-01,-7,17791732,7
Serbia,201407,8,966851,120856.375,765157,1,16181,16181,16181,-0.9670794033154567,9,0,15,9.158227638847206e-4,4,0.01573517338583962,0.9402118610266621,2014-07-01,7,983032,7
TFYR of Macedonia,201407,12,811087,67590.5833333333,408566,0,0,0,0,-1,12,0,30,9.687609853622369e-4,1,0,0.7887395448983683,2014-07-01,12,811087,7
Australia,201407,5,93022,18604.4,76866,0,0,0,0,-1,5,0,4,3.846838587465648e-8,5,0,0.0904590135775028,2014-07-01,5,93022,7
Belarus,201407,1,534731,534731,534731,2,225900,112950,213300,-0.4060194759351118,3,0,2,1.331049522151394e-4,2,0.2196758956715388,0.5199978369558992,2014-07-01,-1,760631,7
China,201407,4,598943,149735.75,450921,0,0,0,0,-1,4,0,1,2.6528873517067973e-6,2,0,0.5824406373669698,2014-07-01,4,598943,7
Croatia,201407,2,40390,20195,40041,8,317558,39694.75,122553,0.7743247622559701,10,122,20,0.0021138178250513563,4,0.308808490826306,0.03927715549434906,2014-07-01,-6,357948,7
India,201407,5,31723,6344.6,25566,0,0,0,0,-1,5,0,1,4.5728645939826013e-7,6,0,0.030848952803843407,2014-07-01,5,31723,7
Guatemala,201407,1,3251,3251,3251,0,0,0,0,-1,1,0,0,0,7,0,0.0031614269005231193,2014-07-01,1,3251,7
Honduras,201407,1,11729,11729,11729,0,0,0,0,-1,1,0,0,0,7,0,0.011405837008992824,2014-07-01,1,11729,7
Thailand,201407,3,284373,94791,212104,3,319,106.333333333333,265,-0.9977589816362946,6,1,5,3.626135336114437e-7,5,3.102107601559136e-4,0.27653781974237496,2014-07-01,0,284692,7
Cyprus,201407,1,213,213,213,1,14196,14196,14196,0.9704351447012284,2,0,0,7.824286191693958e-7,1,0.013804865050700155,2.071313226119423e-4,2014-07-01,0,14409,7
Denmark,201407,5,154381,30876.2,123177,22,1174500,53386.3636363636,804872,0.7676526340582791,27,272,103,0.026105056916175783,1,1.1421396169376818,0.1501274212026022,2014-07-01,-17,1328881,7
Canada,201407,2,48339,24169.5,32061,8,1255400,156925,761209,0.9258455871919149,10,126,2,6.856400983996804e-4,6,1.22081062162926,0.047007140862622906,2014-07-01,-6,1303739,7
Colombia,201407,1,148,148,148,0,0,0,0,-1,1,0,0,2.839388204586628e-9,6,0,1.439222335519599e-4,2014-07-01,1,148,7
Dominican Rep.,201407,2,8067,4033.5,7905,0,0,0,0,-1,2,0,0,1.4505036068915544e-6,6,0,0.007844734176105815,2014-07-01,2,8067,7
Mexico,201407,1,410299,410299,410299,0,0,0,0,-1,1,0,0,7.871609090142904e-6,6,0,0.3989942466495649,2014-07-01,1,410299,7
United States of America,201407,7,788789,112684.142857143,761209,0,0,0,0,-1,7,0,0,1.4605795686039322e-5,8,0,0.7670559100082224,2014-07-01,7,788789,7
Lebanon,201407,1,742,742,742,0,0,0,0,-1,1,0,0,2.2284327198897098e-6,1,0,7.21556062807799e-4,2014-07-01,1,742,7
South Africa,201407,4,9993,2498.25,6610,1,250,250,250,-0.951186175925022,5,43,1,2.5708984323947293e-6,6,2.4311188099993228e-4,0.009717668107329294,2014-07-01,3,10243,7
Romania,201407,8,1830281,228785.125,720329,9,213609,23734.3333333333,96199,-0.7909779880521945,17,53,40,0.019186340847957208,1,0.20772354315405814,1.7798522266737482,2014-07-01,-1,2043890,7
Bosnia Herzegovina,201407,2,973669,486834.5,851116,5,47952,9590.4,39344,-0.9061256571664051,7,0,13,0.020568542063856395,4,0.04663080367083501,0.9468420082452923,2014-07-01,-3,1021621,7
Slovenia,201407,3,2019,673,1449,10,323133,32313.3,127162,0.9875811927959847,13,774,32,0.0033382626352532955,4,0.31422988577260447,0.0019633715509554533,2014-07-01,-7,325152,7
"China, Hong Kong SAR",201407,1,479,479,479,9,559774,62197.1111111111,450921,0.9982900582415445,10,47,6,1.4803705144812167e-4,5,0.5443508402994244,4.6580236399587025e-4,2014-07-01,-8,560253,7
Iran,201407,2,606,303,578,0,0,0,0,-1,2,0,0,6.562466997867787e-12,2,0,5.893031995438359e-4,2014-07-01,2,606,7
Japan,201407,4,91287,22821.75,85507,0,0,0,0,-1,4,0,4,3.58770893894422e-7,5,0,0.08877181712336328,2014-07-01,4,91287,7
Viet Nam,201407,1,612,612,612,0,0,0,0,-1,1,0,0,1.4083443337672187e-10,5,0,5.951378846878342e-4,2014-07-01,1,612,7
Ecuador,201407,2,339,169.5,230,0,0,0,0,-1,2,0,1,1.123273302911632e-6,1,0,3.296597106359082e-4,2014-07-01,2,339,7
Suriname,201407,1,2559,2559,2559,0,0,0,0,-1,1,0,0,7.160397584868273e-5,1,0,0.002488493213915307,2014-07-01,1,2559,7
Georgia,201407,1,219011,219011,219011,0,0,0,0,-1,1,0,0,9.500814851319177e-5,1,0,0.2129767046787047,2014-07-01,1,219011,7
Indonesia,201407,1,296,296,296,1,159,159,159,-0.3010989010989011,2,1,1,2.381988918617027e-10,5,1.5461915631595694e-4,2.878444671039198e-4,2014-07-01,0,455,7
Rep. of Korea,201407,2,7994,3997,7869,0,0,0,0,-1,2,0,0,3.2695956619716644e-8,5,0,0.007773745506853835,2014-07-01,2,7994,7
Malaysia,201407,2,809639,404819.5,808433,9,231179,25686.5555555556,212104,-0.5557744005195914,11,14,9,8.224142030020716e-6,5,0.2248094461507334,0.7873314408836167,2014-07-01,-7,1040818,7
Dominica,201407,2,438,219,353,0,0,0,0,-1,2,0,0,1.8725599822095874e-15,8,0,4.259320155118814e-4,2014-07-01,2,438,7
Saudi Arabia,201407,1,185418,185418,185418,0,0,0,0,-1,1,0,0,6.654439591031951e-9,6,0,0.18030927500498178,2014-07-01,1,185418,7
Kenya,201407,1,1282,1282,1282,0,0,0,0,-1,1,0,0,4.600949845600119e-11,6,0,0.0012466777257676529,2014-07-01,1,1282,7
Oman,201407,1,17290,17290,17290,0,0,0,0,-1,1,0,0,6.205182855288002e-10,6,0,0.016813617689955318,2014-07-01,1,17290,7
Morocco,201407,1,60,60,60,0,0,0,0,-1,1,0,0,2.645955964931659e-9,1,0,5.834685143998375e-5,2014-07-01,1,60,7
New Zealand,201407,2,1122,561,860,1,76866,76866,76866,0.971226342514233,3,1,1,1.168009928191181e-9,5,0.07474815137976318,0.001091086121927696,2014-07-01,1,77988,7
Kyrgyzstan,201407,1,2003,2003,2003,0,0,0,0,-1,1,0,0,4.126477879075622e-13,2,0,0.0019478123905714575,2014-07-01,1,2003,7
Russian Federation,201407,1,1244,1244,1244,12,1420722,118393.5,534731,0.9982503097823717,13,52,14,2.1091205055114986e-4,2,1.3815775911919432,0.001209724719855663,2014-07-01,-11,1421966,7
Venezuela,201407,1,13788,13788,13788,0,0,0,0,-1,1,0,0,3.1161059245887234e-12,8,0,0.013408106460908266,2014-07-01,1,13788,7
Nicaragua,201407,1,4570,4570,4570,0,0,0,0,-1,1,0,0,2.396895063737947e-6,1,0,0.004444085184678762,2014-07-01,1,4570,7
United Arab Emirates,201407,1,45,45,45,0,0,0,0,-1,1,0,0,0,9,0,4.376013857998781e-5,2014-07-01,1,45,7
Saint Kitts and Nevis,201407,1,136,136,136,0,0,0,0,-1,1,0,0,0,8,0,1.3225286326396316e-4,2014-07-01,1,136,7
Sri Lanka,201407,1,366,366,366,0,0,0,0,-1,1,0,0,8.840576910733088e-6,1,0,3.5591579378390086e-4,2014-07-01,1,366,7
Egypt,201407,1,2342,2342,2342,0,0,0,0,-1,1,0,0,5.657003039603423e-5,1,0,0.002277472101207366,2014-07-01,1,2342,7
Paraguay,201407,0,0,0,0,1,12973,12973,12973,1,1,0,0,0,3,0.012615561728848486,0,2014-07-01,-1,12973,7
Montenegro,201407,0,0,0,0,2,5083,2541.5,4097,1,2,0,1,1.3171673619926554e-7,4,0.004942950764490623,0,2014-07-01,-2,5083,7
El Salvador,201407,0,0,0,0,2,14980,7490,11729,1,2,0,0,0,7,0.014567263909515942,0,2014-07-01,-2,14980,7
Iceland,201407,0,0,0,0,1,1227,1227,1227,1,1,0,0,3.4332973179492425e-5,1,0.0011931931119476677,0,2014-07-01,-1,1227,7
Norway,201407,0,0,0,0,10,318297,31829.7,152493,1,10,0,19,0.00755860943718291,1,0.30952712954654177,0,2014-07-01,-10,318297,7
Rep. of Moldova,201407,0,0,0,0,1,332,332,332,1,1,0,0,1.782366827550964e-7,1,3.2285257796791007e-4,0,2014-07-01,-1,332,7
Panama,201407,0,0,0,0,1,209,209,209,1,1,0,0,8.541582438645681e-11,8,2.032415325159434e-4,0,2014-07-01,-1,209,7
Malta,201407,0,0,0,0,2,13241,6620.5,12754,1,2,0,1,1.8976060705767157e-5,4,0.012876177665280413,0,2014-07-01,-2,13241,7
Switzerland,201407,0,0,0,0,11,811725,73793.1818181818,347800,1,11,0,39,0.006942183685773413,1,0.7893599664186801,0,2014-07-01,-11,811725,7
Singapore,201407,0,0,0,0,10,918805,91880.5,808433,1,10,0,7,2.8738828204085128e-5,5,0.8934896472885712,0,2014-07-01,-10,918805,7
Ethiopia,201407,0,0,0,0,1,292,292,292,1,1,0,0,2.1675460676866172e-11,2,2.839546770079209e-4,0,2014-07-01,-1,292,7
Antigua and Barbuda,201407,0,0,0,0,2,2025,1012.5,1940,1,2,0,0,7.928550446575219e-10,8,0.0019692062360994514,0,2014-07-01,-2,2025,7
Qatar,201407,0,0,0,0,6,290165,48360.8333333333,185418,1,6,0,1,1.2826044541156108e-6,6,0.2821702358013814,0,2014-07-01,-6,290165,7
Bermuda,201407,0,0,0,0,1,5102,5102,5102,1,1,0,0,2.0851270641336245e-9,8,0.004961427267446618,0,2014-07-01,-1,5102,7
Mozambique,201407,0,0,0,0,2,6750,3375,6610,1,2,0,0,3.3004310996480643e-9,6,0.006564020786998172,0,2014-07-01,-2,6750,7
Fiji,201407,0,0,0,0,1,860,860,860,1,1,0,0,2.8100984141626402e-14,5,8.36304870639767e-4,0,2014-07-01,-1,860,7
Kazakhstan,201407,0,0,0,0,4,34732,8683,30907,1,4,0,1,7.362730503934064e-9,2,0.03377504740355859,0,2014-07-01,-4,34732,7
Zambia,201407,0,0,0,0,1,71,71,71,1,1,0,0,5.1075130605079036e-12,6,6.904377420398077e-5,0,2014-07-01,-1,71,7
Aruba,201407,0,0,0,0,2,33551,16775.5,19763,1,2,0,0,8.076905601835006e-9,8,0.032626586877714914,0,2014-07-01,-2,33551,7
Cabo Verde,201407,0,0,0,0,1,39,39,39,1,1,0,0,7.869442662866885e-10,1,3.792545343598944e-5,0,2014-07-01,-1,39,7
Madagascar,201407,0,0,0,0,1,45,45,45,1,1,0,0,0,9,4.376013857998781e-5,0,2014-07-01,-1,45,7
Montserrat,201407,0,0,0,0,2,489,244.5,353,1,2,0,0,0,8,4.755268392358676e-4,0,2014-07-01,-2,489,7
Trinidad and Tobago,201408,1,751,751,751,0,0,0,0,-1,1,0,0,5.050696920639158e-18,1,0,9.035244011679749e-4,2014-08-01,1,751,8
Netherlands,201408,29,46535294,1604665.31034483,22402652,6,1628201,271366.833333333,901014,-0.9323885860027392,35,125,135,1,2,1.9588806038696376,55.98638301534707,2014-08-01,23,48163495,8
Poland,201408,17,1381461,81262.4117647059,378439,10,800204,80020.4,539706,-0.26642816381066753,27,189,95,0.02853244892875373,2,0.9627214912279869,1.6620289251157279,2014-08-01,7,2181665,8
Portugal,201408,7,81378,11625.4285714286,73541,2,23208,11604,21789,-0.5561929895014629,9,46,16,0.0014858537697278714,2,0.027921430495747482,0.09790547099633483,2014-08-01,5,104586,8
Spain,201408,23,7033288,305795.130434783,5118417,9,109684,12187.1111111111,42372,-0.9692889738333008,32,721,122,0.18368865066534745,2,0.1319602801833664,8.461714152386023,2014-08-01,14,7142972,8
Sweden,201408,4,104988,26247,44629,8,1878581,234822.625,1564229,0.8941423262815662,12,0,35,0.06027226899629268,2,2.260111548695786,0.12631054571214825,2014-08-01,-4,1983569,8
Turkey,201408,14,726640,51902.8571428571,251899,0,0,0,0,-1,14,0,46,0.0024092572369330476,2,0,0.8742170051460683,2014-08-01,14,726640,8
United Kingdom,201408,6,279153,46525.5,194061,13,13753186,1057937.38461538,13136423,0.9602129053467138,19,153,52,0.4751846523767052,2,16.546390339283324,0.33584759941310743,2014-08-01,-7,14032339,8
Austria,201408,10,1233976,123397.6,411651,11,1279321,116301.909090909,388761,0.018042038008241765,21,0,90,0.028114513234108542,2,1.5391447941765841,1.4845904480101904,2014-08-01,-1,2513297,8
Belgium,201408,14,3706618,264758.428571429,2180668,8,4543299,567912.375,3684218,0.10141689910334856,22,775,77,0.24364330542622134,2,5.466020650202475,4.45941385993134,2014-08-01,6,8249917,8
Bulgaria,201408,7,1646068,235152.571428571,1145948,4,270994,67748.5,251899,-0.7172819658414803,11,37,18,0.037185364064929526,2,0.32603154669788836,1.9803763035709268,2014-08-01,3,1917062,8
Czech Rep.,201408,6,106260,17710,63989,20,4199206,209960.3,1152498,0.9506394894304124,26,354,109,0.06221532263544045,2,5.052044056632446,0.1278408826472823,2014-08-01,-14,4305466,8
Estonia,201408,4,24674,6168.5,23368,5,143800,28760,79642,0.7070883341049657,9,132,15,4.4916229819640547e-4,2,0.17300507175493313,0.02968516787539096,2014-08-01,-1,168474,8
Finland,201408,1,49,49,49,7,784222,112031.714285714,521684,0.9998750431929779,8,30,18,0.02357440072259878,2,0.9434936257426785,5.895165866475468e-5,2014-08-01,-6,784271,8
France,201408,16,1265301,79081.3125,657358,13,4023094,309468.769230769,2175869,0.5214801466229357,29,121,110,0.10629039675451184,2,4.840164576820869,1.5222774012280156,2014-08-01,3,5288395,8
Germany,201408,23,3830773,166555.347826087,1152498,17,33139581,1949387.11764706,22402652,0.7927651436607829,40,884,124,0.879705765850439,2,39.870066681734485,4.608784128942006,2014-08-01,6,36970354,8
Greece,201408,6,109586,18264.3333333333,42372,3,165923,55307.6666666667,143680,0.20448333811236657,9,3,16,3.4789351384096614e-4,2,0.19962114409453247,0.13184237686603686,2014-08-01,3,275509,8
Hungary,201408,8,1142799,142849.875,286975,7,345774,49396.2857142857,114095,-0.5354288973399356,15,125,51,0.013163289194084328,2,0.4159989963907528,1.3748958483759792,2014-08-01,1,1488573,8
Ireland,201408,2,77451,38725.5,77426,10,757104,75710.4,672826,0.8143897046929202,12,40,30,0.026210857074002992,3,0.9108680935044986,0.09318091663763092,2014-08-01,-8,834555,8
Italy,201408,16,81279,5079.9375,18823,8,679443,84930.375,390007,0.7863108993824288,24,679,79,0.00828587567470281,2,0.8174345269011616,0.09778636458393053,2014-08-01,8,760722,8
Latvia,201408,3,92493,30831,79642,4,107163,26790.75,78872,0.07347637937252073,7,40,9,1.0131529894550507e-4,2,0.1289272774998185,0.11127787275263581,2014-08-01,-1,199656,8
Brazil,201408,1,13139,13139,13139,0,0,0,0,-1,1,0,0,2.525348460319579e-18,4,0,0.015807466187677793,2014-08-01,1,13139,8
Serbia,201408,7,502123,71731.8571428571,388761,2,61998,30999,53330,-0.7801960926822437,9,43,15,5.456479321870908e-4,2,0.07458948844688695,0.604101708239237,2014-08-01,5,564121,8
India,201408,8,56747,7093.375,31631,0,0,0,0,-1,8,0,1,2.0149548136007434e-6,3,0,0.06827203620915988,2014-08-01,8,56747,8
Slovenia,201408,4,1897,474.25,1478,14,257913,18422.3571428571,102620,0.9853970208998883,18,205,48,7.383679576771205e-4,2,0.31029386002454845,0.00228227135687836,2014-08-01,-10,259810,8
Thailand,201408,6,272578,45429.6666666667,202712,1,25,25,25,-0.9998165830896946,7,91,3,6.523171339047251e-7,3,3.00773768697728e-5,0.3279372492963572,2014-08-01,5,272603,8
TFYR of Macedonia,201408,10,447981,44798.1,144718,0,0,0,0,-1,10,0,20,4.945795878122817e-4,2,0,0.5389637346999075,2014-08-01,10,447981,8
Croatia,201408,3,41049,13683,33483,7,457328,65332.5714285714,407225,0.8352692840961762,10,487,22,0.0010091314442600083,2,0.5502090643639782,0.04938584972509214,2014-08-01,-4,498377,8
Guatemala,201408,2,13670,6835,13484,0,0,0,0,-1,2,0,0,1.087443159192671e-9,3,0,0.016446309672391766,2014-08-01,2,13670,8
Honduras,201408,2,5971,2985.5,5944,0,0,0,0,-1,2,0,0,1.5785473409250227e-10,3,0,0.007183680691576535,2014-08-01,2,5971,8
Australia,201408,5,76279,15255.8,48321,0,0,0,0,-1,5,0,3,3.887173961161862e-8,5,0,0.09177088920997598,2014-08-01,5,76279,8
Denmark,201408,4,70667,17666.75,67392,20,886120,44306,611861,0.8522826919680138,24,807,94,0.024773989897257067,2,1.0660866076737228,0.08501911965024937,2014-08-01,-16,956787,8
Dominican Rep.,201408,2,7064,3532,3850,0,0,0,0,-1,2,0,0,5.477420481330728e-5,3,0,0.008498663608323001,2014-08-01,2,7064,8
Jordan,201408,5,89649,17929.8,56208,0,0,0,0,-1,5,0,3,5.861316169142863e-4,2,0,0.10785627035993046,2014-08-01,5,89649,8
Lithuania,201408,5,150094,30018.8,78872,4,201323,50330.75,130353,0.14577837725551127,9,0,11,0.0016730065963441725,2,0.24221070974213077,0.18057735215566714,2014-08-01,1,351417,8
Mexico,201408,1,284853,284853,284853,0,0,0,0,-1,1,0,0,1.6653836839746293e-6,3,0,0.3427052413394156,2014-08-01,1,284853,8
Peru,201408,2,1384,692,1215,0,0,0,0,-1,2,0,0,3.4192318724619474e-9,3,0,0.0016650835835106221,2014-08-01,2,1384,8
United States of America,201408,7,811150,115878.571428571,777654,0,0,0,0,-1,7,0,0,4.554787420681557e-6,5,0,0.9758905699166482,2014-08-01,7,811150,8
Canada,201408,1,17889,17889,17889,10,1111181,111118.1,777654,0.9683119735711692,11,0,0,1.6308131684880049e-4,3,1.3368563883012403,0.021522167792934623,2014-08-01,-9,1129070,8
Ukraine,201408,3,929705,309901.666666667,823925,0,0,0,0,-1,3,0,2,1.5774781694951034e-4,5,0,1.1185235065084846,2014-08-01,3,929705,8
Bosnia Herzegovina,201408,5,1693175,338635,1207881,2,43979,21989.5,43821,-0.9493666076812994,7,40,12,0.03820256618955628,2,0.05291091829422952,2.037050503259102,2014-08-01,3,1737154,8
Romania,201408,8,939443,117430.375,712581,8,100501,12562.625,95774,-0.80671843868516,16,743,44,0.0026110424349170204,2,0.12091225811156144,1.1302392463467987,2014-08-01,0,1039944,8
Slovakia,201408,2,140211,70105.5,132075,13,929169,71474.5384615385,218124,0.7377714189530382,15,44,38,0.010010655678547678,2,1.1178786475483968,0.16868716353150856,2014-08-01,-11,1069380,8
Suriname,201408,2,2269,1134.5,2184,0,0,0,0,-1,2,0,1,7.836826202281111e-5,2,0,0.0027298227247005793,2014-08-01,2,2269,8
Luxembourg,201408,3,1681,560.333333333333,896,9,168630,18736.6666666667,116092,0.9802596426537334,12,92,18,0.0016712209877698368,2,0.20287792246199146,0.002022402820723523,2014-08-01,-6,170311,8
Morocco,201408,1,43,43,43,0,0,0,0,-1,1,0,0,2.5762715412931712e-9,2,0,5.173308821600921e-5,2014-08-01,1,43,8
Dominica,201408,2,322,161,200,0,0,0,0,-1,2,0,0,1.2727756240010677e-15,5,0,3.8739661408267363e-4,2014-08-01,2,322,8
Georgia,201408,1,102329,102329,102329,0,0,0,0,-1,1,0,0,3.672404848225867e-5,2,0,0.12311151590827922,2014-08-01,1,102329,8
Iran,201408,1,6380,6380,6380,0,0,0,0,-1,1,0,0,2.104893093767131e-12,5,0,0.007675746577166018,2014-08-01,1,6380,8
Lebanon,201408,1,944,944,944,0,0,0,0,-1,1,0,0,3.597123267433617e-6,2,0,0.0011357217506026208,2014-08-01,1,944,8
Sri Lanka,201408,1,333,333,333,0,0,0,0,-1,1,0,0,1.0501974758861314e-5,2,0,4.0063065990537364e-4,2014-08-01,1,333,8
Egypt,201408,1,1878,1878,1878,0,0,0,0,-1,1,0,0,5.9227353144559616e-5,2,0,0.0022594125504573326,2014-08-01,1,1878,8
Ecuador,201408,2,377,188.5,333,0,0,0,0,-1,2,0,1,2.2378920929321444e-6,2,0,4.5356684319617377e-4,2014-08-01,2,377,8
Azerbaijan,201408,1,14456,14456,14456,1,6380,6380,6380,-0.387598387406412,2,2,0,9.202787178998068e-9,5,0.007675746577166018,0.01739194240117742,2014-08-01,0,20836,8
Armenia,201408,1,9124,9124,9124,0,0,0,0,-1,1,0,0,5.808399682163396e-9,5,0,0.01097703946239228,2014-08-01,1,9124,8
Belarus,201408,1,1394457,1394457,1394457,2,224100,112050,188700,-0.7230866753534166,3,0,1,1.9410699943032812e-4,5,0.26961360626064335,1.6776643487077105,2014-08-01,-1,1618557,8
China,201408,4,268225,67056.25,242637,0,0,0,0,-1,4,0,2,3.74773560719139e-7,5,0,0.32270017643579235,2014-08-01,4,268225,8
Kazakhstan,201408,1,71,71,71,4,44168,11042,33136,0.9967901625262777,5,1,2,4.311213171941215e-10,5,0.053138303263364994,8.541975031015475e-5,2014-08-01,-3,44239,8
Uzbekistan,201408,2,33617,16808.5,33136,0,0,0,0,-1,2,0,1,3.0671997516941113e-10,5,0,0.04044444712924609,2014-08-01,2,33617,8
Oman,201408,1,16055,16055,16055,0,0,0,0,-1,1,0,0,3.2125578345381354e-8,3,0,0.01931569142576809,2014-08-01,1,16055,8
Saudi Arabia,201408,1,220053,220053,220053,0,0,0,0,-1,1,0,0,4.4031951986562613e-7,3,0,0.2647446804929645,2014-08-01,1,220053,8
Japan,201408,3,42291,14097,35934,0,0,0,0,-1,3,0,2,6.424090994291475e-8,5,0,0.05088009380798245,2014-08-01,3,42291,8
Malaysia,201408,2,780265,390132.5,778759,8,219308,27413.5,202712,-0.5611966309614205,10,9,10,1.0762007851785927e-5,5,0.2638483746622453,0.9387329785317309,2014-08-01,-6,999573,8
South Africa,201408,1,15750,15750,15750,1,90,90,90,-0.9886363636363636,2,1,0,6.501262126943645e-12,3,1.0827855673118207e-4,0.018948747427956863,2014-08-01,0,15840,8
New Zealand,201408,2,847,423.5,444,1,48321,48321,48321,0.9655466970387244,3,1,1,6.767591032349499e-10,5,0.05813475710897165,0.0010190215283479025,2014-08-01,1,49168,8
Rep. of Korea,201408,2,7098,3549,6832,0,0,0,0,-1,2,0,0,1.0331429362889994e-8,5,0,0.008539568840865893,2014-08-01,2,7098,8
Kyrgyzstan,201408,1,1723,1723,1723,0,0,0,0,-1,1,0,0,2.66348502109906e-14,5,0,0.002072932813864741,2014-08-01,1,1723,8
Russian Federation,201408,1,418,418,418,9,2278866,253207.333333333,1394457,0.9996332181509632,10,48,4,1.7757503860426312e-5,5,2.741692460708466,5.028937412626011e-4,2014-08-01,-8,2279284,8
Venezuela,201408,1,13207,13207,13207,0,0,0,0,-1,1,0,0,1.6263547126273328e-12,5,0,0.015889276652763573,2014-08-01,1,13207,8
Bangladesh,201408,1,553,553,553,0,0,0,0,-1,1,0,0,2.1335741833285494e-10,5,0,6.653115763593743e-4,2014-08-01,1,553,8
Viet Nam,201408,1,1171,1171,1171,0,0,0,0,-1,1,0,0,4.517930040027449e-10,5,0,0.0014088243325801578,2014-08-01,1,1171,8
Saint Kitts and Nevis,201408,1,68,68,68,0,0,0,0,-1,1,0,0,7.576045380958737e-18,5,0,8.181046508578201e-5,2014-08-01,1,68,8
Barbados,201408,0,0,0,0,1,751,751,751,1,1,0,0,5.050696920639158e-18,1,9.035244011679749e-4,0,2014-08-01,-1,751,8
Paraguay,201408,0,0,0,0,1,13139,13139,13139,1,1,0,0,-0,4,0.015807466187677793,0,2014-08-01,-1,13139,8
El Salvador,201408,0,0,0,0,2,19428,9714,13484,1,2,0,0,5.593242783854217e-13,3,0.023373731113037838,0,2014-08-01,-2,19428,8
Iceland,201408,0,0,0,0,1,980,980,980,1,1,0,0,3.51330111763821e-5,2,0.0011790331732950937,0,2014-08-01,-1,980,8
Montenegro,201408,0,0,0,0,3,27259,9086.33333333333,13642,1,3,0,1,6.007507707208585e-7,2,0.03279516864372547,0,2014-08-01,-3,27259,8
Norway,201408,0,0,0,0,7,907743,129677.571428571,869436,1,7,0,8,0.03130365134064525,3,1.0921011324759267,0,2014-08-01,-7,907743,8
Antigua and Barbuda,201408,0,0,0,0,2,1889,944.5,1767,1,2,0,0,2.885319811982543e-10,5,0.0022726465962800324,0,2014-08-01,-2,1889,8
Cyprus,201408,0,0,0,0,2,25948,12974,18515,1,2,0,0,2.3464887192979267e-4,2,0.031217911000674583,0,2014-08-01,-2,25948,8
Malta,201408,0,0,0,0,2,17923,8961.5,14594,1,2,0,1,1.236798172395911e-4,2,0.021563073025477515,0,2014-08-01,-2,17923,8
Panama,201408,0,0,0,0,1,275,275,275,1,1,0,0,4.490453162879334e-11,5,3.3085114556750077e-4,0,2014-08-01,-1,275,8
Switzerland,201408,0,0,0,0,11,696262,63296.5454545455,210961,1,11,0,38,0.0036792906774467263,2,0.8376693829640699,0,2014-08-01,-11,696262,8
Rep. of Moldova,201408,0,0,0,0,1,615,615,615,1,1,0,0,5.756762915996921e-8,2,7.399034709964108e-4,0,2014-08-01,-1,615,8
Qatar,201408,0,0,0,0,9,301330,33481.1111111111,220053,1,9,0,4,5.581505368310851e-5,3,0.36252863888674547,0,2014-08-01,-9,301330,8
Singapore,201408,0,0,0,0,8,889980,111247.5,778759,1,8,0,6,4.365216701208182e-5,5,1.0707305546624157,0,2014-08-01,-8,889980,8
Bermuda,201408,0,0,0,0,1,4978,4978,4978,1,1,0,0,8.128535435073418e-10,5,0.00598900728230916,0,2014-08-01,-1,4978,8
Mozambique,201408,0,0,0,0,1,15750,15750,15750,1,1,0,0,3.676907358225307e-15,3,0.018948747427956863,0,2014-08-01,-1,15750,8
Fiji,201408,0,0,0,0,1,444,444,444,1,1,0,0,1.0775661880183643e-14,5,5.341742132071649e-4,0,2014-08-01,-1,444,8
Indonesia,201408,0,0,0,0,2,464,232,266,1,2,0,0,3.744586696961872e-13,5,5.582361147029832e-4,0,2014-08-01,-2,464,8
Aruba,201408,0,0,0,0,2,34243,17121.5,21036,1,2,0,0,3.4349519848023473e-9,5,0.0411975846460652,0,2014-08-01,-2,34243,8
"China, Hong Kong SAR",201408,0,0,0,0,10,314292,31429.2,242637,1,10,0,7,4.218161994927558e-5,5,0.3781231572461853,0,2014-08-01,-10,314292,8
Montserrat,201408,0,0,0,0,2,268,134,200,1,2,0,0,1.5152090761917475e-17,5,3.224294800439644e-4,0,2014-08-01,-2,268,8
Algeria,201408,0,0,0,0,1,17606,17606,17606,1,1,0,0,1.2717897178607651e-9,3,0.021181691886768796,0,2014-08-01,-1,17606,8
Cabo Verde,201408,0,0,0,0,1,48,48,48,1,1,0,0,2.5568579856128277e-9,2,5.774856358996377e-5,0,2014-08-01,-1,48,8
Italy,201409,18,216338,12018.7777777778,56980,9,550750,61194.4444444444,289831,0.43594998227061305,27,691,102,0.008496578629425015,1,0.6709552400891926,0.26355536038205307,2014-09-01,9,767088,9
Netherlands,201409,30,45248843,1508294.76666667,24030512,8,1694185,211773.125,801152,-0.9278195262563804,38,416,130,1,1,2.0639533425883045,55.124735939760654,2014-09-01,22,46943028,9
Belgium,201409,11,3196496,290590.545454545,1833645,7,4246829,606689.857142857,3596089,0.14111072672495156,18,1,63,0.22743419958980726,1,5.173730678733991,3.8941547728082497,2014-09-01,4,7443325,9
Czech Rep.,201409,6,1914819,319136.5,1802166,17,3142893,184876.058823529,844697,0.242812164868225,23,325,89,0.10324451693220221,1,3.8288525236307627,2.332742336581657,2014-09-01,-11,5057712,9
Germany,201409,24,4100767,170865.291666667,844697,21,35172757,1674893.19047619,24030512,0.7911688800831828,45,709,170,0.9261096381903131,1,42.84947002729701,4.995789572464527,2014-09-01,3,39273524,9
Spain,201409,27,8345097,309077.666666667,4465913,9,169621,18846.7777777778,57951,-0.9601581637818187,36,230,136,0.17643896625237496,1,0.2066420313738882,10.1664758260601,2014-09-01,18,8514718,9
Suriname,201409,1,2877,2877,2877,0,0,0,0,-1,1,0,0,1.0154805030473826e-4,1,0,0.0035049264198576614,2014-09-01,1,2877,9
Sweden,201409,5,331104,66220.8,195509,8,1514398,189299.75,1363548,0.6411773056870164,13,0,36,0.04985610431030045,1,1.8449265069098375,0.40336988436585025,2014-09-01,-3,1845502,9
Turkey,201409,15,1830934,122062.266666667,988139,0,0,0,0,-1,15,0,46,0.03353579373331852,1,0,2.2305488180798285,2014-09-01,15,1830934,9
United Kingdom,201409,8,37282,4660.25,15904,11,11664813,1060437.54545455,10780105,0.9936281494894718,19,10,74,0.38669942630000126,1,14.2107442705593,0.04541907083251072,2014-09-01,-3,11702095,9
Austria,201409,11,1314810,119528.181818182,582519,14,1554209,111014.928571429,709129,0.0834428074543947,25,12,93,0.04800698170364145,1,1.893426550601514,1.6017769572794758,2014-09-01,-3,2869019,9
Ecuador,201409,2,185,92.5,162,0,0,0,0,-1,2,0,1,1.7221306775074964e-7,1,0,2.2537761128733658e-4,2014-09-01,2,185,9
Romania,201409,8,1318350,164793.75,678275,8,120680,15085,91256,-0.8322759080769685,16,276,33,0.018779162980932757,2,0.14701929800084204,1.606089588327893,2014-09-01,0,1439030,9
Bulgaria,201409,7,805707,115101,464848,4,362479,90619.75,209925,-0.3794156067612521,11,40,22,0.011989613053666972,2,0.4415927089828242,0.9815584813918168,2014-09-01,3,1168186,9
France,201409,15,640622,42708.1333333333,359241,16,4328079,270504.9375,2177075,0.742137029376491,31,472,102,0.09748121690892736,1,5.272714089096673,0.7804424653952223,2014-09-01,-1,4968701,9
Hungary,201409,6,42460,7076.66666666667,17731,6,383906,63984.3333333333,204541,0.8008283962604898,12,0,33,0.008126616330750805,1,0.467696309399331,0.05172720743383952,2014-09-01,0,426366,9
Poland,201409,16,984303,61518.9375,420869,7,737874,105410.571428571,567468,-0.1430915637591258,23,260,75,0.033550665504505264,2,0.8989204300055794,1.1991343725565364,2014-09-01,9,1722177,9
TFYR of Macedonia,201409,17,1279878,75286.9411764706,219874,0,0,0,0,-1,17,0,55,0.005202381767611867,1,0,1.5592207912389933,2014-09-01,17,1279878,9
Croatia,201409,3,70644,23548,60945,8,343783,42972.875,219874,0.6590762667490294,11,32,34,5.253516059841102e-4,1,0.4188161694118618,0.08606257282044652,2014-09-01,-5,414427,9
Greece,201409,8,107539,13442.375,41283,3,83942,27980.6666666667,66053,-0.1232341590027209,11,25,27,0.0011118180276191501,1,0.10226295917125193,0.13101017805529128,2014-09-01,5,191481,9
Portugal,201409,6,60515,10085.8333333333,57951,2,12269,6134.5,12235,-0.6628654649373489,8,181,13,4.4089795274875244e-4,1,0.0149467995291045,0.07372284403812526,2014-09-01,4,72784,9
Slovenia,201409,5,138747,27749.4,133138,13,304635,23433.4615384615,141798,0.37414238737702477,18,549,38,4.098229153089847e-4,1,0.37112383034874474,0.1690295536934275,2014-09-01,-8,443382,9
Denmark,201409,2,24682,12341,20347,20,1445825,72291.25,817565,0.9664306256277597,22,335,96,0.034486767675698346,1,1.761386945078451,0.03006902811780563,2014-09-01,-18,1470507,9
Dominican Rep.,201409,5,31911,6382.2,29326,0,0,0,0,-1,5,0,4,6.0535707841762325e-5,3,0,0.038875810561028096,2014-09-01,5,31911,9
Jordan,201409,6,183267,30544.5,104625,0,0,0,0,-1,6,0,12,0.0010247615892275777,1,0,0.22326637128538548,2014-09-01,6,183267,9
Luxembourg,201409,3,908,302.666666666667,658,8,148067,18508.375,73961,0.9878100352408122,11,306,25,0.0014133747875435462,1,0.18038371227287603,0.0011061776813454142,2014-09-01,-5,148975,9
Serbia,201409,8,107745,13468.125,34278,2,89266,44633,82876,-0.09379679307246803,10,119,19,8.718354889805939e-5,1,0.10874896134689399,0.13126113907110312,2014-09-01,6,197011,9
Ukraine,201409,3,3728115,1242705,3421292,0,0,0,0,-1,3,0,1,4.424198790721202e-5,4,0,4.541803531375615,2014-09-01,3,3728115,9
Egypt,201409,3,1113,371,916,0,0,0,0,-1,3,0,2,3.0272483169496773e-5,1,0,0.0013559204397989493,2014-09-01,3,1113,9
Bosnia Herzegovina,201409,3,121047,40349,58886,4,76684,19171,53831,-0.22436036837926274,7,118,9,0.0018346505749023642,1,0.09342084726463848,0.1474663984513418,2014-09-01,-1,197731,9
Colombia,201409,1,201,201,201,0,0,0,0,-1,1,0,0,2.0934440362146027e-9,5,0,2.448697290202954e-4,2014-09-01,1,201,9
Kenya,201409,1,1170,1170,1170,0,0,0,0,-1,1,0,0,1.2185718956404283e-8,5,0,0.001425361109222615,2014-09-01,1,1170,9
Lebanon,201409,2,1694,847,1079,0,0,0,0,-1,2,0,1,3.7189707265411505e-6,5,0,0.002063727964977017,2014-09-01,2,1694,9
Oman,201409,1,18937,18937,18937,0,0,0,0,-1,1,0,0,1.9723158949608265e-7,5,0,0.023070139594315097,2014-09-01,1,18937,9
Saudi Arabia,201409,1,237192,237192,237192,0,0,0,0,-1,1,0,0,2.470388930406099e-6,5,0,0.28896089933224833,2014-09-01,1,237192,9
India,201409,8,71969,8996.125,33394,0,0,0,0,-1,8,0,0,1.7880759803854931e-6,6,0,0.08767676382020717,2014-09-01,8,71969,9
Morocco,201409,4,4971,1242.75,4200,0,0,0,0,-1,4,0,1,1.6580172775760616e-8,2,0,0.006055957328158649,2014-09-01,4,4971,9
Peru,201409,1,1168,1168,1168,0,0,0,0,-1,1,0,0,1.216488866904524e-8,5,0,0.0014229245945059953,2014-09-01,1,1168,9
Swaziland,201409,1,97,97,97,0,0,0,0,-1,1,0,0,1.0102690177552753e-9,5,0,1.1817096375606297e-4,2014-09-01,1,97,9
United States of America,201409,9,808343,89815.8888888889,726811,0,0,0,0,-1,9,0,5,3.6513211488270503e-6,6,0,0.9847698077883217,2014-09-01,9,808343,9
Afghanistan,201409,1,10182,10182,10182,0,0,0,0,-1,1,0,0,5.052602214101762e-18,7,0,0.01240429642231168,2014-09-01,1,10182,9
Bahamas,201409,1,585,585,585,0,0,0,0,-1,1,0,0,1.2631505535254404e-17,7,0,7.126805546113075e-4,2014-09-01,1,585,9
Australia,201409,4,24740,6185,14443,0,0,0,0,-1,4,0,3,3.4726904857898275e-8,8,0,0.030139687044587606,2014-09-01,4,24740,9
Israel,201409,1,2,2,2,0,0,0,0,-1,1,0,0,3.778353619813047e-12,8,0,2.436514716619855e-6,2014-09-01,1,2,9
Japan,201409,4,80962,20240.5,73986,2,38148,19074,35817,-0.3594492485937369,6,6,6,1.4790200189633233e-7,8,0.046474081704807116,0.09863255224348835,2014-09-01,2,119110,9
Malaysia,201409,2,764816,382408,763812,9,245520,27280,216980,-0.5139834668862636,11,19,13,1.1419345430112291e-5,8,0.2991065466122534,0.9317427197531655,2014-09-01,-7,1010336,9
Nepal,201409,1,21,21,21,0,0,0,0,-1,1,0,0,3.967264353475655e-11,8,0,2.5583404524508477e-5,2014-09-01,1,21,9
Thailand,201409,6,282070,47011.6666666667,216980,0,0,0,0,-1,6,0,2,1.5818939595839717e-6,4,0,0.34363385305848126,2014-09-01,6,282070,9
South Africa,201409,2,4283,2141.5,3840,1,298,298,298,-0.8698974023139052,3,2,0,1.8807649851103762e-11,6,3.630406927763584e-4,0.00521779626564142,2014-09-01,1,4581,9
New Zealand,201409,2,624,312,445,0,0,0,0,-1,2,0,0,7.829783867289054e-10,8,0,7.601925915853947e-4,2014-09-01,2,624,9
Azerbaijan,201409,2,1873561,936780.5,1872779,0,0,0,0,-1,2,0,1,1.8193334255177722e-5,4,0,2.282479474492506,2014-09-01,2,1873561,9
China,201409,5,529617,105923.4,279725,0,0,0,0,-1,5,0,2,4.0807214498553685e-6,4,0,0.6452098073360288,2014-09-01,5,529617,9
Iran,201409,3,18123,6041,16471,0,0,0,0,-1,3,0,1,6.043407868376827e-7,4,0,0.022078478104650814,2014-09-01,3,18123,9
Kyrgyzstan,201409,1,6558,6558,6558,0,0,0,0,-1,1,0,0,1.5192787752685365e-9,4,0,0.007989331755796504,2014-09-01,1,6558,9
Russian Federation,201409,1,712,712,712,14,8023619,573115.642857143,3421292,0.9998225397232492,15,9,7,2.752261630039422e-4,4,9.774832887025342,8.673992391166683e-4,2014-09-01,-13,8024331,9
Turkmenistan,201409,1,1126,1126,1126,0,0,0,0,-1,1,0,0,2.6085818246391294e-10,4,0,0.0013717577854569782,2014-09-01,1,1126,9
Uzbekistan,201409,1,283048,283048,283048,0,0,0,0,-1,1,0,0,6.557316517132267e-8,4,0,0.34482530875490836,2014-09-01,1,283048,9
Rep. of Korea,201409,2,2406,1203,2331,0,0,0,0,-1,2,0,1,1.441314755960809e-10,8,0,0.0029311272040936855,2014-09-01,2,2406,9
Indonesia,201409,1,152,152,152,1,594,594,594,0.5924932975871313,2,2,1,6.199368096666254e-11,8,7.236448708360969e-4,1.8517511846310897e-4,2014-09-01,0,746,9
Singapore,201409,1,3393,3393,3393,10,870219,87021.9,763812,0.9922322495570116,11,4,7,5.3522948052260856e-5,8,1.0601507000911068,0.004133547216745584,2014-09-01,-9,873612,9
Viet Nam,201409,1,1474,1474,1474,0,0,0,0,-1,1,0,0,5.941148721602893e-10,8,0,0.001795711346148833,2014-09-01,1,1474,9
Dominica,201409,2,233,116.5,125,0,0,0,0,-1,2,0,0,6.871539011178396e-16,6,0,2.838539644862131e-4,2014-09-01,2,233,9
Uganda,201409,1,305,305,305,0,0,0,0,-1,1,0,0,5.052602214101762e-18,9,0,3.715684942845279e-4,2014-09-01,1,305,9
Armenia,201409,1,12587,12587,12587,0,0,0,0,-1,1,0,0,1.2227669040429268e-7,4,0,0.015334205369047057,2014-09-01,1,12587,9
Belarus,201409,1,2160238,2160238,2160238,5,332e3,66400,306500,-0.7335727968195653,6,0,4,4.1356138161205846e-5,2,0.4044614429588959,2.6317258392007212,2014-09-01,-4,2492238,9
Georgia,201409,1,1260,1260,1260,0,0,0,0,-1,1,0,0,1.2240297928463946e-8,4,0,0.0015350042714705086,2014-09-01,1,1260,9
Kazakhstan,201409,1,27932,27932,27932,8,302210,37776.25,283048,0.8307879639670203,9,4,3,6.563482461163821e-6,4,0.36816955625484316,0.034028364532312894,2014-09-01,-7,330142,9
Ireland,201409,2,56503,28251.5,56478,10,638717,63871.7,542536,0.8374528926095337,12,89,25,0.02083063118633788,1,0.7781216851276419,0.06883519551658583,2014-09-01,-8,695220,9
Venezuela,201409,1,15397,15397,15397,0,0,0,0,-1,1,0,0,2.2340939632027336e-12,6,0,0.018757508545897954,2014-09-01,1,15397,9
Estonia,201409,5,59386,11877.2,38819,7,208502,29786,76437,0.5566356089111868,12,172,23,0.002592079235273426,3,0.2540090957223365,0.07234743148059335,2014-09-01,-2,267888,9
Finland,201409,2,10696,5348,10648,6,862743,143790.5,338139,0.9755083068193657,8,1,15,0.021316381588656792,3,1.0510430080803816,0.013030480704482985,2014-09-01,-4,873439,9
Lithuania,201409,4,108423,27105.75,73387,6,296229,49371.5,199612,0.464117315619347,10,42,23,9.846367899814918e-4,3,0.3608831589947915,0.13208711756003727,2014-09-01,-2,404652,9
Brazil,201409,1,11863,11863,11863,0,0,0,0,-1,1,0,0,7.578903321152643e-18,10,0,0.01445218704163067,2014-09-01,1,11863,9
Albania,201409,2,1366,683,1208,0,0,0,0,-1,2,0,0,1.0281107298097153e-8,1,0,0.001664139551451361,2014-09-01,2,1366,9
Guatemala,201409,1,22170,22170,22170,0,0,0,0,-1,1,0,0,8.233215307878821e-15,6,0,0.027008765633731092,2014-09-01,1,22170,9
Honduras,201409,2,16441,8220.5,11093,0,0,0,0,-1,2,0,0,5.566882980138732e-8,6,0,0.020029369227973517,2014-09-01,2,16441,9
Canada,201409,1,20031,20031,20031,7,1501804,214543.428571429,726811,0.9736752013194597,8,0,0,1.421776514311921e-4,6,1.8295837737392824,0.024402913144306156,2014-09-01,-6,1521835,9
Mexico,201409,1,690313,690313,690313,0,0,0,0,-1,1,0,0,3.464249123407874e-6,6,0,0.8409788917870009,2014-09-01,1,690313,9
Latvia,201409,2,89833,44916.5,51350,5,122392,24478.4,73387,0.15341736364707267,7,0,10,2.221975680425181e-4,3,0.14910495459826864,0.10943971326905572,2014-09-01,-3,212225,9
Slovakia,201409,1,20717,20717,20717,13,493928,37994.4615384615,147015,0.9194901339758474,14,0,53,0.007601287116105085,1,0.6017314204753058,0.02523863769210677,2014-09-01,-12,514645,9
Malta,201409,0,0,0,0,2,16835,8417.5,13881,1,2,0,1,1.0842878693396738e-4,1,0.02050936262714763,0,2014-09-01,-2,16835,9
Rep. of Moldova,201409,0,0,0,0,1,344,344,344,1,1,0,0,2.2801656627430787e-7,2,4.1908053125861507e-4,0,2014-09-01,-1,344,9
Qatar,201409,0,0,0,0,17,382395,22493.8235294118,237192,1,17,0,24,2.9507578281791835e-4,5,0.4658555225309247,0,2014-09-01,-17,382395,9
Bermuda,201409,0,0,0,0,1,10129,10129,10129,1,1,0,0,1.3054142043175027e-9,6,0.012339728782321256,0,2014-09-01,-1,10129,9
Pakistan,201409,0,0,0,0,2,10767,5383.5,10182,1,2,0,0,1.5157806642305286e-17,7,0.01311697697692299,0,2014-09-01,-2,10767,9
Panama,201409,0,0,0,0,1,434,434,434,1,1,0,0,5.593344587190578e-11,6,5.287236935065086e-4,0,2014-09-01,-1,434,9
Mozambique,201409,0,0,0,0,1,3840,3840,3840,1,1,0,0,2.5540904192284404e-15,6,0.0046781082559101215,0,2014-09-01,-1,3840,9
Fiji,201409,0,0,0,0,1,179,179,179,1,1,0,0,4.951550169819727e-15,8,2.1806806713747703e-4,0,2014-09-01,-1,179,9
Zambia,201409,0,0,0,0,1,443,443,443,1,1,0,0,3.031561328461057e-16,6,5.396880097312979e-4,0,2014-09-01,-1,443,9
"China, Hong Kong SAR",201409,0,0,0,0,11,319078,29007.0909090909,222784,1,11,0,11,4.9849181107936235e-5,8,0.388719121374815,0,2014-09-01,-11,319078,9
Cyprus,201409,0,0,0,0,3,5211,1737,4198,1,3,0,2,3.421442594750292e-5,1,0.006348339094153032,0,2014-09-01,-3,5211,9
Montserrat,201409,0,0,0,0,1,108,108,108,1,1,0,0,5.052602214101762e-18,6,1.3157179469747217e-4,0,2014-09-01,-1,108,9
Rwanda,201409,0,0,0,0,1,305,305,305,1,1,0,0,7.578903321152643e-18,9,3.715684942845279e-4,0,2014-09-01,-1,305,9
Algeria,201409,0,0,0,0,1,30524,30524,30524,1,1,0,0,1.9264562151398384e-9,6,0.03718608760505222,0,2014-09-01,-1,30524,9
Cabo Verde,201409,0,0,0,0,2,579,289.5,570,1,2,0,1,3.5499171959645625e-6,1,7.05371010461448e-4,0,2014-09-01,-2,579,9
Aruba,201409,0,0,0,0,2,47294,23647,31897,1,2,0,0,4.110850931185956e-9,6,0.057616263503909707,0,2014-09-01,-2,47294,9
Paraguay,201409,0,0,0,0,1,11863,11863,11863,1,1,0,0,1.0105204428203523e-17,10,0.01445218704163067,0,2014-09-01,-1,11863,9
El Salvador,201409,0,0,0,0,2,27518,13759,22170,1,2,0,0,1.0508391979684415e-11,6,0.033524005985972584,0,2014-09-01,-2,27518,9
Iceland,201409,0,0,0,0,1,1233,1233,1233,1,1,0,0,4.352059298774966e-5,1,0.0015021113227961405,0,2014-09-01,-1,1233,9
Montenegro,201409,0,0,0,0,4,26461,6615.25,20202,1,4,0,2,1.1618632471395498e-6,1,0.032236307958238994,0,2014-09-01,-4,26461,9
Norway,201409,0,0,0,0,9,749161,83240.1111111111,714561,1,9,0,14,0.025354164562086348,1,0.9126709008088235,0,2014-09-01,-9,749161,9
Antigua and Barbuda,201409,0,0,0,0,2,1311,655.5,1186,1,2,0,0,1.5285038239699468e-10,6,0.0015971353967443149,0,2014-09-01,-2,1311,9
Switzerland,201409,0,0,0,0,10,816117,81611.7,251315,1,10,0,19,0.010837983783724445,1,0.9942405404918231,0,2014-09-01,-10,816117,9
Romania,201410,11,1021553,92868.4545454545,525159,11,189153,17195.7272727273,123292,-0.6875327288375543,22,492,70,0.010244487585314595,1,0.1226371220130629,0.6623226694993495,2014-10-01,0,1210706,10
Turkey,201410,21,6716010,319810,4449661,0,0,0,0,-1,21,0,56,0.017190662352997644,1,0,4.354317075652782,2014-10-01,21,6716010,10
Ukraine,201410,3,2176790,725596.666666667,1807399,1,218550,218550,218550,-0.8175206859986474,4,0,4,2.160930384509107e-4,2,0.14169663191149437,1.4113192010003288,2014-10-01,2,2395340,10
United States of America,201410,8,1417349,177168.625,1328183,0,0,0,0,-1,8,0,2,0.0011790602467504543,3,0,0.9189365341712407,2014-10-01,8,1417349,10
Colombia,201410,2,41,20.5,21,0,0,0,0,-1,2,0,0,3.409384706764657e-8,1,0,2.65823011135725e-5,2014-10-01,2,41,10
Morocco,201410,4,184466,46116.5,82700,0,0,0,0,-1,4,0,4,0.0016591005160124194,1,0,0.1195983111516162,2014-10-01,4,184466,10
Netherlands,201410,29,40657047,1401967.13793103,20020945,9,11002432,1222492.44444444,9073374,-0.5740401485659582,38,513,138,0.9037530090932435,1,7.133413668429407,26.359947944943155,2014-10-01,20,51659479,10
Spain,201410,28,55544997,1983749.89285714,19983407,13,300629,23125.3076923077,140670,-0.9892335704142702,41,71,143,0.8522667858608537,1,0.19491245369444357,36.01253257576783,2014-10-01,15,55845626,10
Brazil,201410,1,14781,14781,14781,0,0,0,0,-1,1,0,0,1.4517422324458744e-17,4,0,0.009583243725846709,2014-10-01,1,14781,10
Austria,201410,9,285636,31737.3333333333,134942,12,3018380,251531.666666667,968293,0.8270976895995661,21,164,78,0.050105587884424464,1,1.9569630740289015,0.18519176002137547,2014-10-01,-3,3304016,10
Croatia,201410,5,81684,16336.8,33971,7,183581,26225.8571428571,97924,0.3841328482837917,12,45,26,0.0015990564820331833,1,0.11902452245684764,0.0529597240039282,2014-10-01,-2,265265,10
Germany,201410,22,7618611,346300.5,1479429,18,44120934,2451163,20020945,0.7055014302889598,40,214,150,1,1,28.605754951220945,4.939517357784773,2014-10-01,4,51739545,10
Hungary,201410,8,26133,3266.625,20022,5,425699,85139.8,262763,0.8843242621151224,13,38,39,0.009453038985595545,1,0.27600143906699265,0.016943299390268052,2014-10-01,3,451832,10
Serbia,201410,6,169258,28209.6666666667,118486,3,126210,42070,109958,-0.14569428838317516,9,42,15,2.2325228262648804e-5,1,0.08182810301326793,0.10973822248490375,2014-10-01,3,295468,10
India,201410,7,38168,5452.57142857143,35005,0,0,0,0,-1,7,0,1,2.4885051586743266e-6,1,0,0.024746177290313053,2014-10-01,7,38168,10
TFYR of Macedonia,201410,16,1287280,80455,266501,2,60151,30075.5,35265,-0.9107175061283287,18,0,49,0.0032433373451829905,1,0.03899882912884145,0.8346064531092587,2014-10-01,14,1347431,10
Italy,201410,19,994845,52360.2631578947,548323,9,518046,57560.6666666667,211661,-0.31515753613446046,28,751,89,0.015959064767767747,1,0.33587450640687266,0.6450065695446837,2014-10-01,10,1512891,10
Poland,201410,13,513160,39473.8461538462,165383,12,2532215,211017.916666667,1601011,0.6629906005007593,25,251,96,0.05746249563229093,1,1.6417585759586582,0.332706674132704,2014-10-01,1,3045375,10
Sweden,201410,4,35040,8760,12426,7,6161265,880180.714285714,3050883,0.9886900338185418,11,0,28,0.13998852222876507,1,3.994648816354031,0.022718142219989766,2014-10-01,-3,6196305,10
Thailand,201410,4,243808,60952,181192,0,0,0,0,-1,4,0,2,1.6354465359693732e-7,5,0,0.15807262609507033,2014-10-01,4,243808,10
Guatemala,201410,2,15016,7508,14811,0,0,0,0,-1,2,0,0,1.819780081194361e-7,6,0,0.009735605695644016,2014-10-01,2,15016,10
Honduras,201410,2,42454,21227,35933,0,0,0,0,-1,2,0,0,3.1897256785620575e-5,6,0,0.02752500027989285,2014-10-01,2,42454,10
Armenia,201410,2,15168,7584,13704,0,0,0,0,-1,2,0,0,8.300826606670369e-7,2,0,0.009834154714406528,2014-10-01,2,15168,10
Albania,201410,10,341325,34132.5,128568,0,0,0,0,-1,10,0,25,1.5659422498678636e-4,1,0,0.22129765677049104,2014-10-01,10,341325,10
Belgium,201410,12,3078500,256541.666666667,2041734,8,6195514,774439.25,4410166,0.3361019295420516,20,229,59,0.2206538983644527,1,4.016854114667171,1.9959418043447057,2014-10-01,4,9274014,10
Dominican Rep.,201410,4,99595,24898.75,98825,0,0,0,0,-1,4,0,1,8.944466662465085e-5,1,0,0.06457229949771348,2014-10-01,4,99595,10
France,201410,18,984897,54716.5,347633,14,7790885,556491.785714286,6066745,0.7755420542579567,32,190,93,0.17843541967199483,1,5.051211000273543,0.6385567956062003,2014-10-01,4,8775782,10
Portugal,201410,6,25372,4228.66666666667,20480,4,184043,46010.75,164186,0.7576868896688393,10,225,18,0.004166854532615162,1,0.11932405960598105,0.01644990594764784,2014-10-01,2,209415,10
Egypt,201410,5,21801,4360.2,18196,0,0,0,0,-1,5,0,5,5.829627925187501e-5,1,0,0.01413465235553644,2014-10-01,5,21801,10
Canada,201410,1,27810,27810,27810,14,5115533,365395.214285714,2109817,0.9891860216205686,15,0,2,0.03358846911780906,6,3.316649721034558,0.018030580340693932,2014-10-01,-13,5143343,10
Costa Rica,201410,1,229,229,229,0,0,0,0,-1,1,0,0,2.0328031571348257e-7,6,0,1.4847187695141712e-4,2014-10-01,1,229,10
Ecuador,201410,3,2801,933.666666666667,2538,0,0,0,0,-1,3,0,2,7.714639537506463e-6,6,0,0.0018160250102223553,2014-10-01,3,2801,10
Jordan,201410,6,224389,37398.1666666667,116984,0,0,0,0,-1,6,0,8,0.0017465174557756587,1,0,0.1454823405993517,2014-10-01,6,224389,10
Mexico,201410,1,2109817,2109817,2109817,0,0,0,0,-1,1,0,0,0.0018728570560467663,6,0,1.3678973363057119,2014-10-01,1,2109817,10
Peru,201410,1,989,989,989,0,0,0,0,-1,1,0,0,8.779224114954246e-7,6,0,6.412169707639805e-4,2014-10-01,1,989,10
Czech Rep.,201410,4,134029,33507.25,106415,17,3551951,208938.294117647,1329158,0.9272763281406844,21,257,87,0.05361676276775406,1,2.302903195674511,0.0868975423402685,2014-10-01,-13,3685980,10
Slovenia,201410,2,842,421,767,10,294063,29406.3,103109,0.9942896865092148,12,169,23,7.663524036983328e-4,1,0.19065539542342608,5.459096960397084e-4,2014-10-01,-8,294905,10
Latvia,201410,2,120384,60192,64187,9,531583,59064.7777777778,287638,0.6307052350809167,11,0,27,0.00775994461523165,1,0.3446512042160051,0.07805082285991004,2014-10-01,-7,651967,10
Lithuania,201410,6,72652,12108.6666666667,26633,8,917248,114656,469062,0.8532134559046368,14,81,31,0.015686804425491408,1,0.5946966471176134,0.04710383757325047,2014-10-01,-2,989900,10
Bulgaria,201410,8,910893,113861.625,441260,4,340918,85229.5,165776,-0.45532033190313875,12,0,34,0.004303559098231496,1,0.22103377880577826,0.5905763904450096,2014-10-01,4,1251811,10
United Kingdom,201410,7,144944,20706.2857142857,63090,12,15873601,1322800.08333333,9544515,0.9819029755823641,19,189,55,0.3707666645434494,1,10.291630281431843,0.09397426957574762,2014-10-01,-5,16018545,10
Greece,201410,10,399334,39933.4,103459,5,22155,4431,17590,-0.8948727013041858,15,162,34,0.0017279093466013725,1,0.01436416783344387,0.2589077227533502,2014-10-01,5,421489,10
Slovakia,201410,1,2481,2481,2481,15,844219,56281.2666666667,311855,0.994139600803118,16,42,68,0.012833143152426578,1,0.5473483820438796,0.0016085533917749603,2014-10-01,-14,846700,10
Lebanon,201410,1,588,588,588,0,0,0,0,-1,1,0,0,2.7728605352977213e-6,1,0,3.812290988970885e-4,2014-10-01,1,588,10
Afghanistan,201410,1,17546,17546,17546,0,0,0,0,-1,1,0,0,1.1613937859566995e-17,7,0,0.011375928178993733,2014-10-01,1,17546,10
Denmark,201410,5,107612,21522.4,89318,20,2375107,118755.35,1435035,0.9133111721463444,25,651,95,0.054840907171689386,1,1.539897791486679,0.06977011188862839,2014-10-01,-15,2482719,10
Estonia,201410,5,55352,11070.4,35081,6,169190,28198.3333333333,64187,0.5069786498739657,11,114,21,0.0015327885855270856,1,0.10969413476598368,0.03588740320093817,2014-10-01,-1,224542,10
Russian Federation,201410,2,15661,7830.5,15e3,14,25190418,1799315.57142857,8612354,0.998757363253523,16,14,10,0.0022872723331466686,2,16.33217747445748,0.010153790676577047,2014-10-01,-12,25206079,10
Luxembourg,201410,3,625,208.333333333333,317,8,217770,27221.25,88792,0.9942764257423475,11,267,27,0.0027546316935566765,1,0.14119091984152884,4.052180047800686e-4,2014-10-01,-5,218395,10
Finland,201410,1,47,47,47,7,1095531,156504.428571429,497793,0.9999142005407191,8,93,17,0.025513057784775136,1,0.7102862175915413,3.0472393959461156e-5,2014-10-01,-6,1095578,10
Ireland,201410,2,32610,16305,32583,10,760380,76038,386473,0.9177543222487042,12,23,33,0.01773712819486668,1,0.49299146635946967,0.021142654617404857,2014-10-01,-8,792990,10
Azerbaijan,201410,1,8612354,8612354,8612354,0,0,0,0,-1,1,0,0,5.206062569636852e-4,2,0,5.5838094469434285,2014-10-01,1,8612354,10
Belarus,201410,1,1087244,1087244,1087244,7,1174600,167800,671100,0.038621584866153455,8,2,6,7.776621640713168e-4,2,0.7615505094634697,0.7049133510225614,2014-10-01,-6,2261844,10
China,201410,5,2886556,577311.2,2609306,0,0,0,0,-1,5,0,3,1.5809653628383877e-4,5,0,1.871495140809497,2014-10-01,5,2886556,10
Iran,201410,2,5952384,2976192,5938856,0,0,0,0,-1,2,0,1,3.5900169315570066e-4,5,0,3.859221069063686,2014-10-01,2,5952384,10
Kazakhstan,201410,1,186634,186634,186634,6,1798131,299688.5,1756241,0.8119334026950293,7,6,3,1.4314285725352524e-5,5,1.165816089845103,0.12100393136659732,2014-10-01,-5,1984765,10
San Marino,201410,1,103,103,103,0,0,0,0,-1,1,0,0,6.226223930626004e-9,2,0,6.67799271877553e-5,2014-10-01,1,103,10
Uzbekistan,201410,2,1763228,881614,1756241,0,0,0,0,-1,2,0,1,1.0867461180802815e-6,5,0,1.1431867714117612,2014-10-01,2,1763228,10
Dominica,201410,2,417,208.5,318,0,0,0,0,-1,2,0,0,4.412947968499671e-13,3,0,2.7036145278926175e-4,2014-10-01,2,417,10
Israel,201410,2,5623,2811.5,3570,0,0,0,0,-1,2,0,1,4.904044904841355e-5,5,0,0.003645665345405321,2014-10-01,2,5623,10
Suriname,201410,1,5551,5551,5551,0,0,0,0,-1,1,0,0,1.32583847444447e-4,1,0,0.003598984231254657,2014-10-01,1,5551,10
Australia,201410,4,20153,5038.25,9330,0,0,0,0,-1,4,0,3,2.1678598649358753e-8,5,0,0.013066173520532355,2014-10-01,4,20153,10
Bangladesh,201410,2,503,251.5,313,0,0,0,0,-1,2,0,1,1.906606057454688e-10,5,0,3.261194502469992e-4,2014-10-01,2,503,10
Indonesia,201410,1,1500,1500,1500,2,655,327.5,396,-0.39211136890951276,3,2,1,1.442002488001426e-9,5,4.2466846900951184e-4,9.725232114721646e-4,2014-10-01,-1,2155,10
Japan,201410,4,45245,11311.25,40096,1,7449,7449,7449,-0.7172733138497742,5,2,4,2.953928572783235e-7,5,0.00482955026817077,0.029334541802038726,2014-10-01,3,52694,10
Malaysia,201410,2,987861,493930.5,986551,7,189648,27092.5714285714,181192,-0.6778827168199988,9,7,10,9.723718388784512e-7,5,0.12295805467284872,0.6404785014720693,2014-10-01,-5,1177509,10
Nepal,201410,1,24,24,24,0,0,0,0,-1,1,0,0,2.3067434974573e-11,5,0,1.5560371383554633e-5,2014-10-01,1,24,10
South Africa,201410,3,9821,3273.66666666667,8830,1,89,89,89,-0.9820383451059536,4,3,0,5.9344899674815434e-12,8,5.770304388068177e-5,0.006367433639912086,2014-10-01,2,9910,10
New Zealand,201410,2,727,363.5,482,0,0,0,0,-1,2,0,0,7.027700530912918e-10,5,0,4.713495831601758e-4,2014-10-01,2,727,10
Rep. of Korea,201410,2,6469,3234.5,6210,0,0,0,0,-1,2,0,0,9.05437044431934e-9,5,0,0.004194168436675622,2014-10-01,2,6469,10
Kyrgyzstan,201410,1,119,119,119,0,0,0,0,-1,1,0,0,4.501802142184967e-11,5,0,7.715350811012506e-5,2014-10-01,1,119,10
Venezuela,201410,1,5352,5352,5352,0,0,0,0,-1,1,0,0,4.877288787126283e-9,3,0,0.003469962818532683,2014-10-01,1,5352,10
Viet Nam,201410,1,537,537,537,0,0,0,0,-1,1,0,0,1.379992195394809e-11,5,0,3.4816330970703494e-4,2014-10-01,1,537,10
Rep. of Moldova,201410,0,0,0,0,3,66876,22292,40002,1,3,0,2,2.484252434177419e-5,2,0.043358974860274985,0,2014-10-01,-3,66876,10
Paraguay,201410,0,0,0,0,1,14781,14781,14781,1,1,0,0,1.4517422324458744e-17,4,0.009583243725846709,0,2014-10-01,-1,14781,10
Norway,201410,0,0,0,0,6,888005,148000.833333333,489092,1,6,0,8,0.02027757753502336,1,0.5757369829355596,0,2014-10-01,-6,888005,10
El Salvador,201410,0,0,0,0,2,21332,10666,14811,1,2,0,0,5.5683763539932754e-9,6,0.013830576764749476,0,2014-10-01,-2,21332,10
Georgia,201410,0,0,0,0,2,97756,48878,96292,1,2,0,0,4.3747452702451785e-5,2,0.06337998604044862,0,2014-10-01,-2,97756,10
Montenegro,201410,0,0,0,0,3,42349,14116.3333333333,28326,1,3,0,3,4.721345161038619e-7,1,0.0274569236550898,0,2014-10-01,-3,42349,10
Switzerland,201410,0,0,0,0,11,3314337,301303.363636364,2859442,1,11,0,23,0.07215840373300282,1,2.148846442094013,0,2014-10-01,-11,3314337,10
Pakistan,201410,0,0,0,0,1,17546,17546,17546,1,1,0,0,1.4517422324458744e-17,7,0.011375928178993733,0,2014-10-01,-1,17546,10
Iceland,201410,0,0,0,0,2,1738,869,1650,1,2,0,1,4.1391829195177626e-5,1,0.0011268302276924147,0,2014-10-01,-2,1738,10
Cyprus,201410,0,0,0,0,2,9933,4966.5,9863,1,2,0,0,4.799252792616424e-7,1,0.006440048706368674,0,2014-10-01,-2,9933,10
Bosnia Herzegovina,201410,0,0,0,0,5,100493,20098.6,80189,1,5,0,3,7.651775920257746e-6,1,0.06515451672698148,0,2014-10-01,-5,100493,10
Antigua and Barbuda,201410,0,0,0,0,2,2003,1001.5,1685,1,2,0,0,5.250558920156856e-8,3,0.0012986426617191639,0,2014-10-01,-2,2003,10
Bermuda,201410,0,0,0,0,1,27068,27068,27068,1,1,0,0,8.434547701716686e-7,3,0.017549505525419035,0,2014-10-01,-1,27068,10
Malta,201410,0,0,0,0,1,24294,24294,24294,1,1,0,0,1.0246513071096239e-5,1,0.015750985933003177,0,2014-10-01,-1,24294,10
Panama,201410,0,0,0,0,1,371,371,371,1,1,0,0,1.1560577807894221e-8,3,2.405374076374487e-4,0,2014-10-01,-1,371,10
Singapore,201410,0,0,0,0,13,1101013,84693.3076923077,986551,1,13,0,11,3.636788934488944e-5,5,0.7138404657550682,0,2014-10-01,-13,1101013,10
Mauritius,201410,0,0,0,0,1,46,46,46,1,1,0,0,1.7420906789350492e-17,8,2.982404515181305e-5,0,2014-10-01,-1,46,10
Mozambique,201410,0,0,0,0,2,8850,4425,8830,1,2,0,0,1.5754887403395607e-13,5,0.005737886947685771,0,2014-10-01,-2,8850,10
Fiji,201410,0,0,0,0,1,245,245,245,1,1,0,0,4.567181063274721e-15,5,1.588454578737869e-4,0,2014-10-01,-1,245,10
Zambia,201410,0,0,0,0,2,958,479,945,1,2,0,0,3.247763962308564e-9,8,6.211181577268891e-4,0,2014-10-01,-2,958,10
Aruba,201410,0,0,0,0,3,57080,19026.6666666667,50350,1,3,0,0,3.448202249850989e-5,3,0.037007749940554106,0,2014-10-01,-3,57080,10
"China, Hong Kong SAR",201410,0,0,0,0,11,310078,28188.9090909091,244556,1,11,0,7,5.5169182694854714e-5,5,0.20103870157791057,0,2014-10-01,-11,310078,10
Montserrat,201410,0,0,0,0,1,99,99,99,1,1,0,0,1.4517422324458744e-17,3,6.418653195716286e-5,0,2014-10-01,-1,99,10
Benin,201410,0,0,0,0,1,5648,5648,5648,1,1,0,0,2.6634551536220303e-5,1,0.0036618740655965237,0,2014-10-01,-1,5648,10
Austria,201411,10,224755,22475.5,70043,9,2994140,332682.222222222,1102837,0.8603526986745451,19,86,59,0.049625277909370706,1,1.7947513918750686,0.13472294184002118,2014-11-01,1,3218895,11
Germany,201411,21,6558081,312289.571428571,1144380,14,36575376,2612526.85714286,26991341,0.6959167450918669,35,663,126,0.907381934303885,1,21.92406065994041,3.9310536590738714,2014-11-01,7,43133457,11
Italy,201411,23,1055e3,45869.5652173913,607636,8,961312,120164,782743,-0.04646503120548804,31,622,98,0.028757968270343635,1,0.5762309210745676,0.6323895069796994,2014-11-01,15,2016312,11
Spain,201411,34,76796751,2258727.97058824,26991341,14,2223771,158840.785714286,1952604,-0.9437166208545168,48,217,155,1,1,1.3329757785078231,46.033610902874635,2014-11-01,20,79020522,11
Denmark,201411,3,75481,25160.3333333333,71551,20,2536580,126829,1957284,0.9422057907529725,23,725,88,0.06499348902912687,1,1.5204801664593044,0.045244921683729566,2014-11-01,-17,2612061,11
France,201411,19,787234,41433.3684210526,309780,16,6745551,421596.9375,5653504,0.7909846092779762,35,367,113,0.17932885533620246,1,4.043427176489496,0.47188485415891634,2014-11-01,3,7532785,11
Lithuania,201411,4,82331,20582.75,43137,11,1836733,166975.727272727,1221133,0.9141967125640417,15,7,37,0.03871608008462757,2,1.100976944382317,0.04935095781909539,2014-11-01,-7,1919064,11
Netherlands,201411,34,13888878,408496.411764706,7987468,9,10688317,1187590.77777778,9473843,-0.1302248283418836,43,180,161,0.5252184664617576,1,6.4068052304007015,8.325289773385018,2014-11-01,25,24577195,11
Poland,201411,13,302449,23265.3076923077,113339,9,4516937,501881.888888889,3285265,0.8744865009775105,22,95,80,0.11337688163930716,1,2.707548400462903,0.18129438293507405,2014-11-01,4,4819386,11
Slovakia,201411,2,14008,7004,11200,11,767362,69760.1818181818,401885,0.964145027323803,13,75,48,0.01760021742547334,1,0.45997315341702005,0.008396694041489697,2014-11-01,-9,781370,11
India,201411,6,28096,4682.66666666667,24457,0,0,0,0,-1,6,0,1,2.1334719827413044e-6,3,0,0.016841341789669798,2014-11-01,6,28096,11
United Kingdom,201411,8,219366,27420.75,118869,11,14163085,1287553.18181818,9998855,0.9694953245451696,19,99,65,0.34921923553121537,1,8.489655299015713,0.13149266027308887,2014-11-01,-3,14382451,11
Brazil,201411,1,3628,3628,3628,0,0,0,0,-1,1,0,0,5.280851210140676e-18,4,0,0.0021747005984098103,2014-11-01,1,3628,11
Israel,201411,6,102986,17164.3333333333,54900,0,0,0,0,-1,6,0,6,2.460471340394512e-4,2,0,0.06173200546522401,2014-11-01,6,102986,11
Latvia,201411,2,102964,51482,83031,8,623063,77882.875,525498,0.7163631655572038,10,44,17,0.015486383030906655,2,0.3734772543955379,0.06171881819588415,2014-11-01,-6,726027,11
Guyana,201411,1,82,82,82,0,0,0,0,-1,1,0,0,5.280851210140676e-18,5,0,4.9152549357663844e-5,2014-11-01,1,82,11
Albania,201411,14,585671,41833.6428571429,178163,0,0,0,0,-1,14,0,33,1.699956855664525e-4,1,0,0.3510636918884432,2014-11-01,14,585671,11
Greece,201411,12,1520054,126671.166666667,726594,5,24704,4940.8,12063,-0.9680157021358685,17,90,46,0.01896072944046102,1,0.014808104625996679,0.9111527958696873,2014-11-01,7,1544758,11
Serbia,201411,6,172140,28690,154200,5,191814,38362.8,103587,0.05405628183781467,11,76,21,0.001070055514073568,2,0.11497740368891382,0.10318438837107627,2014-11-01,1,363954,11
Turkey,201411,23,23111702,1004856.60869565,15459384,0,0,0,0,-1,23,0,57,0.0075658421415398585,1,0,13.853647235300222,2014-11-01,23,23111702,11
Sweden,201411,3,14401,4800.33333333333,10292,7,5182187,740312.428571429,4088266,0.994457517124698,10,0,23,0.13108819574524766,1,3.1063134426602916,0.008632266625606306,2014-11-01,-4,5196588,11
Algeria,201411,1,6745,6745,6745,0,0,0,0,-1,1,0,0,1.1207580472575666e-5,6,0,0.004043096895334666,2014-11-01,1,6745,11
Bangladesh,201411,2,1723,861.5,1694,0,0,0,0,-1,2,0,0,4.859137156568186e-8,7,0,0.0010328029578445708,2014-11-01,2,1723,11
Dominican Rep.,201411,4,103318,25829.5,85659,0,0,0,0,-1,4,0,1,1.875521462353517e-4,6,0,0.061931013347989186,2014-11-01,4,103318,11
Iran,201411,3,9699324,3233108,9692665,0,0,0,0,-1,3,0,1,0.0010586697810590075,6,0,5.813981727389921,2014-11-01,3,9699324,11
Morocco,201411,9,2828494,314277.111111111,1952604,0,0,0,0,-1,9,0,18,0.05678115814451941,2,0,1.6954596456445858,2014-11-01,9,2828494,11
Portugal,201411,7,21137,3019.57142857143,18869,2,215083,107541.5,151452,0.8210397087460841,9,0,15,0.004364330552594898,2,0.1289253387011514,0.0126699687289383,2014-11-01,5,236220,11
TFYR of Macedonia,201411,13,936576,72044.3076923077,481675,3,178438,59479.3333333333,120059,-0.6799358573076213,16,1,36,6.749768788198838e-4,1,0.1069595439302783,0.5614036349658948,2014-11-01,10,1115014,11
Finland,201411,1,43,43,43,5,1304298,260859.6,825145,0.9999340663216137,6,56,9,0.032074529588951864,6,0.7818240466110029,2.5775117346092017e-5,2014-11-01,-4,1304341,11
Hungary,201411,4,7902,1975.5,6399,6,893479,148913.166666667,585536,0.9824669035624225,10,313,33,0.023453846366588822,1,0.5355703737504407,0.00473662737834463,2014-11-01,-2,901381,11
Ireland,201411,2,14827,7413.5,14803,9,760128,84458.6666666667,283313,0.9617345523288449,11,146,26,0.017045333249718336,1,0.45563693948954026,0.008887620113732706,2014-11-01,-7,774955,11
Jordan,201411,6,400986,66831,135047,0,0,0,0,-1,6,0,8,0.002599509687767826,1,0,0.240359562886978,2014-11-01,6,400986,11
Luxembourg,201411,2,441,220.5,437,9,134617,14957.4444444444,56146,0.9934694723748315,11,113,28,0.0017934773624214756,1,0.08069230166927602,2.6434480813085067e-4,2014-11-01,-7,135058,11
Belgium,201411,9,539354,59928.2222222222,255140,7,2280655,325807.857142857,981696,0.6174806534305387,16,97,39,0.06160051048732752,1,1.3670732616500345,0.3233002939787003,2014-11-01,2,2820009,11
Czech Rep.,201411,5,97606,19521.2,51205,14,2882523,205894.5,1858782,0.9344954530491801,19,105,80,0.06835613633734224,1,1.7278457808792838,0.05850711869029436,2014-11-01,-9,2980129,11
Estonia,201411,3,43785,14595,28394,4,74457,18614.25,54330,0.2594002131222408,7,116,9,0.0015612060671222588,2,0.0446311142380924,0.026245663092991603,2014-11-01,-1,118242,11
Canada,201411,1,4354,4354,4354,11,11162727,1014793.36363636,8194277,0.999220208038251,12,0,2,0.04256003826366801,3,6.691176705288132,0.0026098804866252242,2014-11-01,-10,11167081,11
Guatemala,201411,2,16579,8289.5,16161,0,0,0,0,-1,2,0,0,4.957307554044514e-7,3,0,0.009937806290252548,2014-11-01,2,16579,11
Mexico,201411,3,8197718,2732572.66666667,8194277,0,0,0,0,-1,3,0,0,0.009718666799214463,8,0,4.91388705628304,2014-11-01,3,8197718,11
Egypt,201411,3,66320,22106.6666666667,56080,0,0,0,0,-1,3,0,1,3.216385591056176e-4,3,0,0.03975362284634471,2014-11-01,3,66320,11
United States of America,201411,10,1206255,120625.5,1136638,0,0,0,0,-1,10,0,4,0.001348008086587797,8,0,0.7230549807979122,2014-11-01,10,1206255,11
Croatia,201411,3,30608,10202.6666666667,13308,8,277071,34633.875,87824,0.8010393949538318,11,11,25,0.0034318511862736745,1,0.16608226833021072,0.018347088179748474,2014-11-01,-5,307679,11
Romania,201411,6,74069,12344.8333333333,39600,13,1119930,86148.4615384615,385756,0.8759312193728805,19,313,69,0.01011773177646479,1,0.6713099341722985,0.044398538760643945,2014-11-01,-7,1193999,11
Bulgaria,201411,4,123168,30792,66277,7,953248,136178.285714286,417126,0.7711516737023604,11,7,28,0.0027603523635739997,1,0.571397187440175,0.07382952682054561,2014-11-01,-3,1076416,11
Azerbaijan,201411,2,3512254,1756127,3510525,0,0,0,0,-1,2,0,1,3.83165602452784e-4,6,0,2.1053199767274666,2014-11-01,2,3512254,11
Armenia,201411,1,67485,67485,67485,0,0,0,0,-1,1,0,0,7.365823538926242e-6,2,0,0.040451948700023714,2014-11-01,1,67485,11
Kazakhstan,201411,1,47786,47786,47786,8,460260,57532.5,407983,0.811883175932888,9,11,5,7.0746665925364575e-6,6,0.27588966301656537,0.02864394784884542,2014-11-01,-7,508046,11
Belarus,201411,2,534097,267048.5,533625,13,3270500,251576.923076923,2180500,0.719235966384876,15,31,28,0.006272803096720994,2,1.9604074716370683,0.32014913602780715,2014-11-01,-11,3804597,11
China,201411,4,4187994,1046998.5,3948608,0,0,0,0,-1,4,0,2,4.3116578176993645e-4,7,0,2.5103729487146347,2014-11-01,4,4187994,11
Slovenia,201411,3,12637,4212.33333333333,6810,10,246385,24638.5,96109,0.9024252766174302,13,489,28,0.0014600149434593525,1,0.1476884252864391,0.007574887393082903,2014-11-01,-7,259022,11
Ecuador,201411,1,148,148,148,0,0,0,0,-1,1,0,0,4.6757761050751463e-7,1,0,8.871435737724694e-5,2014-11-01,1,148,11
Dominica,201411,2,658,329,453,0,0,0,0,-1,2,0,0,1.2971302018956442e-12,8,0,3.9441923752857083e-4,2014-11-01,2,658,11
Ukraine,201411,1,55e3,55e3,55e3,3,3011311,1003770.33333333,2977389,0.9641262742102807,4,0,3,0.0012990968037530522,2,1.8050440555948302,0.03296817334965258,2014-11-01,-2,3066311,11
Russian Federation,201411,2,58782,29391,54500,13,33924268,2609559.07692308,15459384,0.9965405106369205,15,8,16,0.003916936889314056,2,20.334929966983125,0.035235184833441416,2014-11-01,-11,33983050,11
Uzbekistan,201411,2,408083,204041.5,407983,0,0,0,0,-1,2,0,0,1.2358317423513134e-7,6,0,0.24461365609175043,2014-11-01,2,408083,11
Honduras,201411,1,9546,9546,9546,0,0,0,0,-1,1,0,0,5.938845270924205e-14,3,0,0.005722076050832427,2014-11-01,1,9546,11
Lebanon,201411,1,393,393,393,0,0,0,0,-1,1,0,0,1.963858581284769e-6,1,0,2.3557258411660844e-4,2014-11-01,1,393,11
Suriname,201411,1,761,761,761,0,0,0,0,-1,1,0,0,1.1137613121571412e-5,1,0,4.561596348924657e-4,2014-11-01,1,761,11
Afghanistan,201411,1,8857,8857,8857,0,0,0,0,-1,1,0,0,5.0168086496336427e-17,7,0,0.005309074751961325,2014-11-01,1,8857,11
Japan,201411,4,29565,7391.25,25706,1,5929,5929,5929,-0.6659153659773482,5,2,4,2.473353891406397e-7,7,0.003553969087092548,0.017721891728772338,2014-11-01,3,35494,11
South Africa,201411,2,4736,2368,4530,1,84,84,84,-0.9651452282157676,3,2,0,4.9938369468695304e-12,3,5.0351392024923936e-5,0.002838859436071902,2014-11-01,1,4820,11
Australia,201411,4,17995,4498.75,8965,0,0,0,0,-1,4,0,2,1.1821889920574741e-8,7,0,0.010786586898672694,2014-11-01,4,17995,11
New Zealand,201411,3,1274,424.666666666667,710,0,0,0,0,-1,3,0,0,6.228512105758204e-10,7,0,7.636627790446797e-4,2014-11-01,3,1274,11
Kyrgyzstan,201411,1,3525,3525,3525,0,0,0,0,-1,1,0,0,6.949164390299013e-10,6,0,0.0021129602010459153,2014-11-01,1,3525,11
Malaysia,201411,3,860266,286755.333333333,859193,10,207487,20748.7,199372,-0.6113576829098115,13,30,11,8.57107928161569e-6,7,0.12437213425089753,0.5156617929965859,2014-11-01,-7,1067753,11
Venezuela,201411,1,4458,4458,4458,0,0,0,0,-1,1,0,0,1.439350020431721e-10,8,0,0.002672220305322749,2014-11-01,1,4458,11
Viet Nam,201411,1,259,259,259,0,0,0,0,-1,1,0,0,1.454582239683531e-10,7,0,1.5525012541018214e-4,2014-11-01,1,259,11
Thailand,201411,3,257926,85975.3333333333,199372,1,136,136,136,-0.9989459897233998,4,1,4,8.076590311043481e-8,7,8.152130137368638e-5,0.15460634689786348,2014-11-01,2,258062,11
Rep. of Korea,201411,2,2118,1059,2049,0,0,0,0,-1,2,0,1,1.8139757440238408e-9,7,0,0.0012695743846284392,2014-11-01,2,2118,11
Singapore,201411,1,424,424,424,10,953151,95315.1,859193,0.9991107149411426,11,59,10,2.0154453375541123e-5,7,0.5713390435708128,2.541546454591399e-4,2014-11-01,-9,953575,11
Uganda,201411,1,43,43,43,0,0,0,0,-1,1,0,0,2.640425605070338e-18,9,0,2.5775117346092017e-5,2014-11-01,1,43,11
Paraguay,201411,0,0,0,0,1,3628,3628,3628,1,1,0,0,5.280851210140676e-18,4,0.0021747005984098103,0,2014-11-01,-1,3628,11
Barbados,201411,0,0,0,0,1,82,82,82,1,1,0,0,-0,5,4.9152549357663844e-5,0,2014-11-01,-1,82,11
Norway,201411,0,0,0,0,6,2365942,394323.666666667,2314887,1,6,0,12,0.06502111070028602,1,1.4181961089313404,0,2014-11-01,-6,2365942,11
Switzerland,201411,0,0,0,0,14,2290075,163576.785714286,2121064,1,14,0,18,0.05962967301463609,6,1.3727198106128295,0,2014-11-01,-14,2290075,11
Georgia,201411,0,0,0,0,1,415766,415766,415766,1,1,0,0,8.765440193659756e-5,1,0.24921901019803008,0,2014-11-01,-1,415766,11
Iceland,201411,0,0,0,0,2,1015,507.5,941,1,2,0,1,1.5834052616047086e-5,1,6.084126536344976e-4,0,2014-11-01,-2,1015,11
Bosnia Herzegovina,201411,0,0,0,0,6,39505,6584.16666666667,13130,1,6,0,6,9.878895464435217e-5,1,0.023680139785055003,0,2014-11-01,-6,39505,11
Antigua and Barbuda,201411,0,0,0,0,3,2915,971.666666666667,2421,1,3,0,0,1.0204341492336081e-7,8,0.0017473131875315867,0,2014-11-01,-3,2915,11
El Salvador,201411,0,0,0,0,2,25707,12853.5,16161,1,2,0,0,2.2324493785754884e-10,3,0.015409324223627615,0,2014-11-01,-2,25707,11
Bermuda,201411,0,0,0,0,1,28824,28824,28824,1,1,0,0,1.082715192116877e-6,8,0.017277720520552473,0,2014-11-01,-1,28824,11
Montenegro,201411,0,0,0,0,5,30142,6028.4,26330,1,5,0,4,9.108040236160589e-7,1,0.018067757838276872,0,2014-11-01,-5,30142,11
Malta,201411,0,0,0,0,3,17137,5712.33333333333,15715,1,3,0,3,3.654051217244501e-5,1,0.010272283394418113,0,2014-11-01,-3,17137,11
Pakistan,201411,0,0,0,0,2,8888,4444,8857,1,2,0,0,2.136685208135019e-13,7,0.005327656813303857,0,2014-11-01,-2,8888,11
Panama,201411,0,0,0,0,1,392,392,392,1,1,0,0,1.4724686210905793e-8,8,2.3497316278297837e-4,0,2014-11-01,-1,392,11
Mozambique,201411,0,0,0,0,1,4530,4530,4530,1,1,0,0,6.337021452168812e-16,3,0.0027153786413441124,0,2014-11-01,-1,4530,11
Fiji,201411,0,0,0,0,2,681,340.5,367,1,2,0,0,1.2635492690503595e-13,7,4.0820592820206195e-4,0,2014-11-01,-2,681,11
"China, Hong Kong SAR",201411,0,0,0,0,10,243869,24386.9,202303,1,10,0,9,3.148172147075497e-5,7,0.14618028121102591,0,2014-11-01,-10,243869,11
Zambia,201411,0,0,0,0,1,206,206,206,1,1,0,0,3.6965958470984736e-17,3,1.2348079472778966e-4,0,2014-11-01,-1,206,11
Samoa,201411,0,0,0,0,1,250,250,250,1,1,0,0,4.346140545945776e-15,7,1.4985533340751173e-4,0,2014-11-01,-1,250,11
Rep. of Moldova,201411,0,0,0,0,2,279180,139590,278991,1,2,0,1,5.88719224842312e-5,1,0.16734644792283648,0,2014-11-01,-2,279180,11
Aruba,201411,0,0,0,0,2,35304,17652,30846,1,2,0,0,1.1586675455057097e-6,8,0.021161970762475175,0,2014-11-01,-2,35304,11
Cyprus,201411,0,0,0,0,2,11867,5933.5,11736,1,2,0,0,6.305704895175948e-6,1,0.007113332966187766,0,2014-11-01,-2,11867,11
Montserrat,201411,0,0,0,0,2,247,123.5,205,1,2,0,0,1.5776449677654387e-9,8,1.4805706940662159e-4,0,2014-11-01,-2,247,11
Rwanda,201411,0,0,0,0,1,43,43,43,1,1,0,0,2.640425605070338e-18,9,2.5775117346092017e-5,0,2014-11-01,-1,43,11
Cabo Verde,201411,0,0,0,0,2,1168,584,1141,1,2,0,1,3.17978662258069e-5,1,7.001241176798948e-4,0,2014-11-01,-2,1168,11
China,201412,4,5908217,1477054.25,4843356,0,0,0,0,-1,4,0,1,0.001233646474441157,1,0,3.1978495076689395,2014-12-01,4,5908217,12
Israel,201412,9,489521,54391.2222222222,384500,0,0,0,0,-1,9,0,12,5.86578515224837e-4,2,0,0.26495548298981014,2014-12-01,9,489521,12
Morocco,201412,12,4328163,360680.25,2625714,0,0,0,0,-1,12,0,33,0.0729852003847532,3,0,2.3426380443813963,2014-12-01,12,4328163,12
Netherlands,201412,32,8627338,269604.3125,5029075,13,15211558,1170119.84615385,13408606,0.27619651514063404,45,352,173,0.4946137222164828,2,8.233325428158363,4.6695862010135265,2014-12-01,19,23838896,12
India,201412,8,307710,38463.75,276895,0,0,0,0,-1,8,0,0,1.5312488956904526e-6,4,0,0.16654944664436147,2014-12-01,8,307710,12
Turkey,201412,23,25970820,1129166.08695652,16757572,0,0,0,0,-1,23,0,53,0.013319954554089805,5,0,14.056825257223736,2014-12-01,23,25970820,12
Azerbaijan,201412,1,375580,375580,375580,1,9630,9630,9630,-0.9500012979933024,2,0,1,9.652062619549482e-5,6,0.005212281600159894,0.20328439495203043,2014-12-01,0,385210,12
Armenia,201412,1,341700,341700,341700,2,120127,60063.5,117419,-0.4797748940620622,3,0,2,1.0117084004081363e-4,6,0.06501928886629363,0.184946689800066,2014-12-01,-1,461827,12
Bulgaria,201412,7,120062,17151.7142857143,88428,8,941126,117640.75,574131,0.7737215271940504,15,669,26,0.003425311308379146,5,0.509388757344972,0.064984107318629,2014-12-01,-1,1061188,12
Belarus,201412,2,1087271,543635.5,1084282,8,5781700,722712.5,3161400,0.6834253631293538,10,2,12,0.019895218857016034,3,3.129371602039923,0.5884904078595481,2014-12-01,-6,6868971,12
France,201412,21,1065537,50739.8571428571,327844,14,6218677,444191.214285714,5390306,0.7074394025216723,35,453,119,0.15554008028337615,7,3.365887404406805,0.5767267808296546,2014-12-01,7,7284214,12
Iran,201412,5,17547685,3509537,17379083,0,0,0,0,-1,5,0,3,0.004416105017557904,6,0,9.497764865098834,2014-12-01,5,17547685,12
Kazakhstan,201412,1,90314,90314,90314,9,1364705,151633.888888889,872144,0.8758586657631275,10,8,10,6.097255477722491e-5,6,0.7386528308563041,0.048882866088976185,2014-12-01,-8,1455019,12
Lithuania,201412,4,84741,21185.25,46595,11,1982816,180256,917995,0.9180278947569522,15,0,39,0.028687567680121807,5,1.0732082402183427,0.0458664543176687,2014-12-01,-7,2067557,12
Egypt,201412,8,113214,14151.75,42845,0,0,0,0,-1,8,0,11,6.93276843921291e-4,8,0,0.06127759595851529,2014-12-01,8,113214,12
Uzbekistan,201412,2,445293,222646.5,441743,0,0,0,0,-1,2,0,1,1.5992393087238309e-6,6,0,0.24101687544963651,2014-12-01,2,445293,12
TFYR of Macedonia,201412,5,152713,30542.6,75970,2,117575,58787.5,83819,-0.13000207186408572,7,0,7,1.0139346891339184e-4,9,0.06363800717952228,0.08265661059244216,2014-12-01,3,270288,12
Denmark,201412,5,69095,13819,60573,25,3130833,125233.32,2604362,0.9568146533297,30,887,125,0.07511423818988655,5,1.6945776987615162,0.037397985167502375,2014-12-01,-20,3199928,12
Germany,201412,21,6548276,311822.666666667,1033212,18,34023003,1890166.83333333,27351107,0.6771964719179793,39,120,150,0.8080934373910723,7,18.415106180590328,3.5442843725408752,2014-12-01,3,40571279,12
Spain,201412,34,87063633,2560695.08823529,27351107,13,3023401,232569.307692308,2625714,-0.9328782208547348,47,203,156,1,7,1.6364296367814148,47.12359006531399,2014-12-01,21,90087034,12
United Kingdom,201412,7,361556,51650.8571428571,185791,11,19848971,1804451.90909091,15660200,0.9642210220446008,18,65,47,0.4528975216264647,7,10.743346451236484,0.1956938407297415,2014-12-01,-4,20210527,12
Austria,201412,8,144778,18097.25,96157,9,3724270,413807.777777778,1285753,0.9251609181380019,17,56,63,0.051011272457217476,9,2.0157781926300613,0.07836175550445994,2014-12-01,-1,3869048,12
Greece,201412,15,3954476,263631.733333333,867089,2,459,229.5,424,-0.9997678849336336,17,84,49,0.022153965833595118,9,2.4843585197023793e-4,2.140378244348276,2014-12-01,13,3954935,12
Italy,201412,22,2394997,108863.5,1071784,9,829500,92166.6666666667,696767,-0.48550114948160905,31,899,92,0.038697065616105863,7,0.44897067365863264,1.296303094033037,2014-12-01,13,3224497,12
United States of America,201412,8,1097918,137239.75,1010380,0,0,0,0,-1,8,0,0,4.613705589695684e-4,10,0,0.5942531453670146,2014-12-01,8,1097918,12
Brazil,201412,1,13466,13466,13466,0,0,0,0,-1,1,0,0,1.0256498643774545e-17,11,0,0.007288534166952558,2014-12-01,1,13466,12
Albania,201412,8,190830,23853.75,85721,0,0,0,0,-1,8,0,4,4.690476687417801e-5,12,0,0.10328761139756101,2014-12-01,8,190830,12
Mexico,201412,2,13394732,6697366,13394630,0,0,0,0,-1,2,0,0,0.006116337598706442,13,0,7.249960035583898,2014-12-01,2,13394732,12
Dominica,201412,2,724,362,629,0,0,0,0,-1,2,0,0,2.31873793089133e-13,13,0,3.918683155260398e-4,2014-12-01,2,724,12
Guyana,201412,1,1902,1902,1902,0,0,0,0,-1,1,0,0,8.229151941952306e-11,14,0,0.0010294662101250382,2014-12-01,1,1902,12
Saint Vincent and the Grenadines,201412,1,279,279,279,0,0,0,0,-1,1,0,0,1.2071162999944948e-11,14,0,1.5101002766818386e-4,2014-12-01,1,279,12
Trinidad and Tobago,201412,1,3542,3542,3542,0,0,0,0,-1,1,0,0,1.5324738986984354e-10,14,0,0.0019171237204326423,2014-12-01,1,3542,12
Estonia,201412,4,242515,60628.75,206749,3,34687,11562.3333333333,23264,-0.7497348503979048,7,114,9,7.770567229890211e-4,15,0.01877449759758528,0.13126235433673694,2014-12-01,1,277202,12
Latvia,201412,4,187543,46885.75,175679,5,754060,150812,640050,0.6016516514921894,9,48,17,0.017279644091698087,15,0.4081384281844828,0.10150850759488962,2014-12-01,-1,941603,12
Poland,201412,10,458436,45843.6,150976,11,4789773,435433.909090909,3792220,0.8252981159858535,21,308,69,0.11810184889230849,5,2.5924865708040143,0.24813058438742483,2014-12-01,-1,5248209,12
Belgium,201412,9,458330,50925.5555555556,151425,7,2649994,378570.571428571,1318085,0.7050950930469282,16,160,32,0.06283031027509615,7,1.4343213880305419,0.24807321140200253,2014-12-01,2,3108324,12
Czech Rep.,201412,3,108978,36326,90083,10,3579863,357986.3,2067518,0.9409147751285566,13,55,53,0.06500860004586065,9,1.9376172425745792,0.058984841559940285,2014-12-01,-7,3688841,12
Guatemala,201412,2,29549,14774.5,29450,0,0,0,0,-1,2,0,0,4.520973904983962e-8,16,0,0.01599353156834109,2014-12-01,2,29549,12
Honduras,201412,2,42221,21110.5,26761,0,0,0,0,-1,2,0,0,7.059442850131933e-6,16,0,0.0228523095992057,2014-12-01,2,42221,12
Dominican Rep.,201412,3,131355,43785,131139,0,0,0,0,-1,3,0,0,6.0050128606002756e-5,16,0,0.07109649528442398,2014-12-01,3,131355,12
Mauritius,201412,1,954,954,954,1,1234,1234,1234,0.12797074954296161,2,0,0,1.4014532221818571e-6,8,6.679081510485264e-4,5.163568688008867e-4,2014-12-01,0,2188,12
Sweden,201412,3,16356,5452,12686,9,4293721,477080.111111111,3504570,0.9924103444091602,12,4,26,0.10053483141535552,7,2.3239961541557776,0.008852759901579983,2014-12-01,-6,4310077,12
Portugal,201412,7,24854,3550.57142857143,22183,2,317896,158948,285574,0.8549730123997082,9,0,17,0.007933467370014491,3,0.17206266579069882,0.013452341317795847,2014-12-01,5,342750,12
Canada,201412,1,11420,11420,11420,17,15345519,902677.588235294,13394630,0.9985127244433282,18,0,5,0.017637101840852425,16,8.30583243287685,0.006181127297385876,2014-12-01,-16,15356939,12
Chile,201412,1,179,179,179,0,0,0,0,-1,1,0,0,8.173607112001921e-8,16,0,9.688456972259824e-5,2014-12-01,1,179,12
Costa Rica,201412,2,16448,8224,16388,0,0,0,0,-1,2,0,0,6.8194798495171015e-6,16,0,0.008902555322889921,2014-12-01,2,16448,12
Cuba,201412,1,5719,5719,5719,0,0,0,0,-1,1,0,0,2.61144464055837e-6,16,0,0.003095434939908041,2014-12-01,1,5719,12
Ecuador,201412,3,1884,628,1331,0,0,0,0,-1,3,0,2,1.0991881362667352e-5,16,0,0.001019723627694833,2014-12-01,3,1884,12
Jordan,201412,7,472373,67481.8571428571,176759,0,0,0,0,-1,7,0,14,0.003304488828543175,7,0,0.2556740494613011,2014-12-01,7,472373,12
Peru,201412,2,1407,703.5,1403,0,0,0,0,-1,2,0,0,6.528770805357639e-7,16,0,7.615451932943895e-4,2014-12-01,2,1407,12
Hungary,201412,4,5204,1301,4939,7,936892,133841.714285714,483496,0.9889522936091438,11,472,47,0.020912960121306466,9,0.5070970854555559,0.002816688831488275,2014-12-01,-3,942096,12
Lebanon,201412,1,390,390,390,0,0,0,0,-1,1,0,0,1.5705090031322917e-6,7,0,2.1108928598778388e-4,2014-12-01,1,390,12
Slovenia,201412,5,28988,5797.6,23441,8,199601,24950.125,99066,0.7463744974605078,13,199,36,0.002156938023350447,2,0.10803495531396833,0.015689887749266357,2014-12-01,-3,228589,12
Slovakia,201412,3,16186,5395.33333333333,13328,9,794959,88328.7777777778,446720,0.9600909825000462,12,46,40,0.01600823601918643,9,0.4302751992296479,0.008760746623072486,2014-12-01,-6,811145,12
Russian Federation,201412,2,24084,12042,21100,17,41796031,2458590.05882353,17379083,0.9988482097669985,19,53,26,0.009812995773616827,5,22.622293181828923,0.013035575291614837,2014-12-01,-15,41820115,12
Serbia,201412,1,969200,969200,969200,5,237810,47562,85721,-0.6059518976644767,6,0,6,0.0013016167206814516,3,0.12871575154039713,0.5245839384086157,2014-12-01,-4,1207010,12
Finland,201412,1,235,235,235,6,913768,152294.666666667,611283,0.9994857784930684,7,44,12,0.020725882461651052,2,0.4945811145602187,1.2719482617212617e-4,2014-12-01,-5,914003,12
Ireland,201412,2,21499,10749.5,21188,8,677064,84633,317467,0.938447928103836,10,34,19,0.013862636020438558,4,0.36646399058469975,0.01163643220372145,2014-12-01,-6,698563,12
Norway,201412,1,111,111,111,8,2232165,279020.625,2199876,0.9999005499319976,9,161,18,0.05701799263981583,2,1.208169528351081,6.007925831960002e-5,2014-12-01,-7,2232276,12
Romania,201412,4,3327,831.75,1529,11,1762912,160264.727272727,867089,0.9962326729281824,15,240,46,0.010263954978311916,7,0.9541841931776821,0.0018007539858496333,2014-12-01,-7,1766239,12
South Africa,201412,2,8859,4429.5,7990,0,0,0,0,-1,2,0,0,2.564124660943636e-17,17,0,0.004794974319399429,2014-12-01,2,8859,12
Croatia,201412,1,761,761,761,6,220822,36803.6666666667,96273,0.9931312420176638,7,3,15,0.003552593911904248,7,0.11952091874460105,4.118947349659065e-4,2014-12-01,-5,221583,12
Australia,201412,3,30155,10051.6666666667,20781,0,0,0,0,-1,3,0,0,1.97237274930432e-7,18,0,0.01632153184349134,2014-12-01,3,30155,12
New Zealand,201412,2,948,474,717,0,0,0,0,-1,2,0,0,6.625498465747507e-9,18,0,5.131093413241515e-4,2014-12-01,2,948,12
Kyrgyzstan,201412,1,3330,3330,3330,0,0,0,0,-1,1,0,0,5.256687156930329e-9,6,0,0.0018023777495880008,2014-12-01,1,3330,12
Luxembourg,201412,2,937,468.5,678,8,128954,16119.25,47513,0.9855725184962777,10,138,21,0.0016190272328022851,7,0.06979694303915046,5.071555409501371e-4,2014-12-01,-6,129891,12
Suriname,201412,1,3181,3181,3181,0,0,0,0,-1,1,0,0,4.073458861245596e-5,2,0,0.0017217308172490782,2014-12-01,1,3181,12
Japan,201412,3,46687,15562.3333333333,41803,0,0,0,0,-1,3,0,2,3.8905367268899437e-7,1,0,0.025269552551055553,2014-12-01,3,46687,12
Venezuela,201412,1,15754,15754,15754,0,0,0,0,-1,1,0,0,2.7543886339136205e-10,10,0,0.008526924644747557,2014-12-01,1,15754,12
Afghanistan,201412,1,8018,8018,8018,0,0,0,0,-1,1,0,0,2.2787478426792534e-12,4,0,0.004339779218077054,2014-12-01,1,8018,12
Indonesia,201412,1,1377,1377,1377,0,0,0,0,-1,1,0,0,7.949889202018204e-10,4,0,7.453075559107138e-4,2014-12-01,1,1377,12
Malaysia,201412,2,825901,412950.5,825021,0,0,0,0,-1,2,0,0,4.844443787471425e-7,1,0,0.447022698427171,2014-12-01,2,825901,12
Viet Nam,201412,2,4004,2002,3714,0,0,0,0,-1,2,0,0,3.448695433647248e-8,1,0,0.0021671833361412477,2014-12-01,2,4004,12
Thailand,201412,2,64940,32470,64880,1,87,87,87,-0.9973241884140434,3,1,2,3.801274061292654e-8,1,4.708914841265948e-5,0.03514907238986329,2014-12-01,1,65027,12
Bangladesh,201412,1,30,30,30,0,0,0,0,-1,1,0,0,1.7320036438256993e-11,4,0,1.6237637383675682e-5,2014-12-01,1,30,12
Rep. of Korea,201412,1,6491,6491,6491,0,0,0,0,-1,1,0,0,5.99806281126329e-8,1,0,0.003513283475247962,2014-12-01,1,6491,12
Cyprus,201412,1,6301,6301,6301,3,9320,3106.66666666667,8873,0.19326547596184623,4,52,5,1.3905964824905172e-5,9,0.005044492680528579,0.0034104451051513492,2014-12-01,-2,15621,12
Panama,201412,0,0,0,0,1,130,130,130,1,1,0,0,1.5528401024132703e-9,10,7.03630953292613e-5,0,2014-12-01,-1,130,12
Georgia,201412,0,0,0,0,1,669358,669358,669358,1,1,0,0,2.3083130454060134e-4,5,0.3622930827954129,0,2014-12-01,-1,669358,12
Paraguay,201412,0,0,0,0,1,13466,13466,13466,1,1,0,0,1.5384747965661818e-17,11,0.007288534166952558,0,2014-12-01,-1,13466,12
Bosnia Herzegovina,201412,0,0,0,0,5,61652,12330.4,22743,1,5,0,2,2.757543292854993e-4,12,0.03336942733261244,0,2014-12-01,-5,61652,12
Antigua and Barbuda,201412,0,0,0,0,3,6736,2245.33333333333,6539,1,3,0,0,9.425981264066007e-8,13,0.0036458908472146467,0,2014-12-01,-3,6736,12
Barbados,201412,0,0,0,0,5,6376,1275.2,3542,1,5,0,0,1.6711328398341108e-6,14,0.0034510391986105385,0,2014-12-01,-5,6376,12
El Salvador,201412,0,0,0,0,2,56211,28105.5,29450,1,2,0,0,4.925567718829031e-9,16,0.030424461165793126,0,2014-12-01,-2,56211,12
Switzerland,201412,0,0,0,0,13,2252666,173282,2144901,1,13,0,18,0.05584421191936815,6,1.2192657884845055,0,2014-12-01,-13,2252666,12
Bermuda,201412,0,0,0,0,1,23069,23069,23069,1,1,0,0,2.75557446387633e-7,10,0.012486201893467145,0,2014-12-01,-1,23069,12
Iceland,201412,0,0,0,0,2,400,200,369,1,2,0,1,5.527856188730718e-6,2,2.1650183178234243e-4,0,2014-12-01,-2,400,12
Montenegro,201412,0,0,0,0,3,53603,17867.6666666667,39094,1,3,0,0,1.4261017250986965e-5,12,0.029012869222572252,0,2014-12-01,-3,53603,12
Mozambique,201412,0,0,0,0,1,7990,7990,7990,1,1,0,0,2.3077121948492726e-17,17,0.00432462408985229,0,2014-12-01,-1,7990,12
Fiji,201412,0,0,0,0,2,583,291.5,352,1,2,0,0,1.8371440370728964e-12,18,3.155514198227641e-4,0,2014-12-01,-2,583,12
Malta,201412,0,0,0,0,2,11628,5814,10210,1,2,0,1,2.8387426275105042e-5,7,0.006293708249912694,0,2014-12-01,-2,11628,12
Zambia,201412,0,0,0,0,1,869,869,869,1,1,0,0,1.0256498643774545e-17,17,4.703502295471389e-4,0,2014-12-01,-1,869,12
Rep. of Moldova,201412,0,0,0,0,2,303064,151532,302800,1,2,0,1,1.0449218075677743e-4,5,0.16403477786820958,0,2014-12-01,-2,303064,12
Aruba,201412,0,0,0,0,2,72289,36144.5,56535,1,2,0,0,6.753063775117559e-7,10,0.03912675229428438,0,2014-12-01,-2,72289,12
Pakistan,201412,0,0,0,0,2,284913,142456.5,276895,1,2,0,0,1.0977272024409574e-8,4,0.1542104659965063,0,2014-12-01,-2,284913,12
Ukraine,201412,0,0,0,0,2,3536027,1768013.5,3430124,1,2,0,0,0.0039247325011882595,5,1.9138908068295524,0,2014-12-01,-2,3536027,12
Singapore,201412,0,0,0,0,14,940696,67192.5714285714,825021,1,14,0,7,2.229942279597601e-5,4,0.509156017875806,0,2014-12-01,-14,940696,12
"China, Hong Kong SAR",201412,0,0,0,0,11,293667,26697,191472,1,11,0,2,3.569159000317784e-4,1,0.15894860858506288,0,2014-12-01,-11,293667,12
Montserrat,201412,0,0,0,0,1,629,629,629,1,1,0,0,1.7948872626605452e-17,13,3.404491304777335e-4,0,2014-12-01,-1,629,12
Cabo Verde,201412,0,0,0,0,2,1979,989.5,1930,1,2,0,1,4.997793181559797e-5,3,0.0010711428127431393,0,2014-12-01,-2,1979,12
Ethiopia,201412,0,0,0,0,1,18,18,18,1,1,0,0,2.30500658614855e-7,2,9.74258243020541e-6,0,2014-12-01,-1,18,12
Australia,201501,4,31241,7810.25,15920,0,0,0,0,-1,4,0,2,3.997423615769628e-8,1,0,0.020134042309406734,2015-01-01,4,31241,1
Sri Lanka,201501,1,55,55,55,0,0,0,0,-1,1,0,0,4.9840890811075157e-11,1,0,3.544612294796487e-5,2015-01-01,1,55,1
France,201501,20,1137717,56885.85,371581,15,7342854,489523.6,6487265,0.7316885855917014,35,494,114,0.18448506858490313,1,4.732285557690102,0.7332301211270863,2015-01-01,5,8480571,1
Lebanon,201501,5,206945,41389,199990,0,0,0,0,-1,5,0,2,2.243813256909328e-5,1,0,0.133370871153938,2015-01-01,5,206945,1
Oman,201501,2,16914,8457,16879,0,0,0,0,-1,2,0,0,3.613849237316378e-8,1,0,0.010900649518943232,2015-01-01,2,16914,1
Netherlands,201501,30,8722565,290752.166666667,3627195,15,13358920,890594.666666667,13111010,0.20996572467839006,45,329,165,0.43725513799426546,1,8.609489468582305,5.6214747529384574,2015-01-01,15,22081485,1
New Zealand,201501,2,472,236,286,0,0,0,0,-1,2,0,0,1.108260100105689e-9,1,0,3.041921823898076e-4,2015-01-01,2,472,1
South Africa,201501,5,44386,8877.2,39248,1,67,67,67,-0.9969855802757969,6,5,0,1.1124229113575028e-9,1,4.3179822500248114e-5,0.02860566569397034,2015-01-01,4,44453,1
United Arab Emirates,201501,1,3116,3116,3116,0,0,0,0,-1,1,0,0,2.8237131086419853e-9,1,0,0.0020081839837428825,2015-01-01,1,3116,1
Greece,201501,17,5450751,320632.411764706,2809744,9,1242456,138050.666666667,831392,-0.6287411998463517,26,187,61,0.07941955683098002,1,0.8007317842443025,3.5128725473589535,2015-01-01,8,6693207,1
Italy,201501,22,2110222,95919.1818181818,859114,7,1231174,175882,1114261,-0.26307806677209167,29,576,80,0.04544344438076454,1,0.7934608177152309,1.3599852447181877,2015-01-01,15,3341396,1
Spain,201501,37,94607917,2556970.72972973,28851503,14,2219750,158553.571428571,1710855,-0.9541505012198631,51,295,156,1,1,1.4305732984317276,60.97243377877919,2015-01-01,23,96827667,1
Iran,201501,11,18125980,1647816.36363636,17505736,0,0,0,0,-1,11,0,5,0.005348076141667915,2,0,11.681740284224587,2015-01-01,11,18125980,1
Trinidad and Tobago,201501,1,424,424,424,0,0,0,0,-1,1,0,0,1.7414649804516374e-12,1,0,2.7325738418067463e-4,2015-01-01,1,424,1
United Kingdom,201501,9,202423,22491.4444444444,110790,14,19553140,1396652.85714286,14820075,0.9795072405681376,23,259,58,0.4272683968103667,1,12.601509171977632,0.1304565553726526,2015-01-01,-5,19755563,1
United States of America,201501,9,1049657,116628.555555556,1022387,0,0,0,0,-1,9,0,1,0.00118415852251172,1,0,0.6764776559125811,2015-01-01,9,1049657,1
Slovakia,201501,4,17790,4447.5,14361,8,816040,102005,444683,0.9573294316587314,12,46,45,0.017140470016084857,1,0.5259173485537681,0.01146520958625991,2015-01-01,-4,833830,1
Austria,201501,9,63107,7011.88888888889,37854,9,3560058,395562,1724440,0.9651647109640328,18,83,68,0.048024217784103276,1,2.2943682467251985,0.04067088147049489,2015-01-01,0,3623165,1
Cuba,201501,1,4320,4320,4320,0,0,0,0,-1,1,0,0,6.282922967154768e-6,1,0,0.0027841318388219676,2015-01-01,1,4320,1
Germany,201501,22,6007444,273065.636363636,1177497,25,36408022,1456320.88,28851503,0.7167333255280043,47,1178,143,0.8045708445234621,1,23.464058620076543,3.8716472477638884,2015-01-01,-3,42415466,1
Hungary,201501,5,13918,2783.6,13621,8,984390,123048.75,516685,0.9721168216622526,13,407,61,0.021537721289360386,1,0.6344147085226752,0.008969802530723183,2015-01-01,-3,998308,1
Morocco,201501,12,2598541,216545.083333333,1710855,1,5,5,5,-0.9999961516940628,13,198,32,0.04821805579973645,1,3.2223748134513515e-6,1.6746946140241377,2015-01-01,11,2598546,1
Poland,201501,11,661053,60095.7272727273,193707,8,7390374,923796.75,6022459,0.8357923384264677,19,59,58,0.17475546227849106,1,4.762911007917144,0.4260321075112913,2015-01-01,3,8051427,1
Romania,201501,5,13757,2751.4,11953,10,1492761,149276.1,728508,0.9817366934878973,15,46,50,0.010463740601821056,1,0.9620470897804906,0.00886604206173005,2015-01-01,-5,1506518,1
Guatemala,201501,4,9701,2425.25,4724,1,6550,6550,6550,-0.19389576026090702,5,4,2,2.772815919739821e-6,1,0.004221311005621271,0.006252051613058312,2015-01-01,3,16251,1
Honduras,201501,3,96053,32017.6666666667,69589,0,0,0,0,-1,3,0,2,2.1498552417272157e-5,1,0,0.06190375359128854,2015-01-01,3,96053,1
Bulgaria,201501,6,47182,7863.66666666667,38185,4,777758,194439.5,573717,0.8856110747448299,10,338,18,0.0036689617150244716,1,0.5012455580320593,0.030407617689652333,2015-01-01,2,824940,1
Czech Rep.,201501,7,280127,40018.1428571429,195945,13,3126549,240503.769230769,1654702,0.8355423292382369,20,277,68,0.05718615504290562,1,2.014982550124302,0.18053483787353736,2015-01-01,-6,3406676,1
Russian Federation,201501,2,2889,1444.5,2589,15,31432349,2095489.93333333,17505736,0.9998161935341479,17,29,21,0.012000366097729904,2,20.257361949042554,0.001861888167212191,2015-01-01,-13,31435238,1
Israel,201501,9,333179,37019.8888888889,194300,0,0,0,0,-1,9,0,15,0.0018960060683207403,1,0,0.21472552359418157,2015-01-01,9,333179,1
Serbia,201501,2,855129,427564.5,854700,5,232153,46430.6,100608,-0.5729663509558698,7,33,11,0.003032612502580246,1,0.14961679601343433,0.5511092303703682,2015-01-01,-3,1087282,1
Tunisia,201501,1,412e3,412e3,412e3,0,0,0,0,-1,1,0,0,2.2531775829480658e-4,2,0,0.2655236846283914,2015-01-01,1,412e3,1
Turkey,201501,24,14098437,587434.875,8397947,0,0,0,0,-1,24,0,53,0.013054551733234925,1,0,9.086089659566127,2015-01-01,24,14098437,1
TFYR of Macedonia,201501,5,668608,133721.6,494200,4,55773,13943.25,52870,-0.8460119743615584,9,4,12,4.274393878118651e-4,1,0.03594430209412445,0.43090111585441626,2015-01-01,1,724381,1
Latvia,201501,2,73185,36592.5,72198,6,742533,123755.5,610641,0.8205629886799114,8,1,9,0.016282858978696853,1,0.4785439274712945,0.04716590014448743,2015-01-01,-4,815718,1
Albania,201501,4,3946,986.5,2471,0,0,0,0,-1,4,0,3,1.9989258071288878e-7,1,0,0.0025430982027758067,2015-01-01,4,3946,1
Belgium,201501,7,318402,45486,214473,8,2260553,282569.125,1229952,0.7530767306913071,15,70,33,0.0520131636812975,1,1.4568698103343787,0.20520211707050745,2015-01-01,-1,2578955,1
Estonia,201501,4,81614,20403.5,45671,3,40802,13600.6666666667,39566,-0.333387792445432,7,175,8,0.0010662391004185121,1,0.02629586742768841,0.05259817960500372,2015-01-01,1,122416,1
Finland,201501,2,66648,33324,66646,6,1571779,261963.166666667,862633,0.918643918831904,8,92,11,0.03234953576399926,1,1.0129722123823504,0.042952967313381135,2015-01-01,-4,1638427,1
Jordan,201501,10,539978,53997.8,189539,0,0,0,0,-1,10,0,18,0.0033680389662374246,1,0,0.3480023014035668,2015-01-01,10,539978,1
Lithuania,201501,2,58707,29353.5,58522,11,1860720,169156.363636364,1074297,0.9388286191660323,13,0,38,0.032921072779468874,1,1.1991874525770398,0.0378351916346577,2015-01-01,-9,1919427,1
Portugal,201501,9,142453,15828.1111111111,101792,3,435137,145045.666666667,349841,0.5067331498121505,12,120,23,0.009885755915981245,1,0.2804349018401562,0.09180739186011708,2015-01-01,6,577590,1
Sweden,201501,3,27202,9067.33333333333,19382,8,5714761,714345.125,4676207,0.9905251914719757,11,33,21,0.13120422292940648,1,3.683020382258812,0.017531007935100734,2015-01-01,-5,5741963,1
Dominican Rep.,201501,2,291917,145958.5,291868,0,0,0,0,-1,2,0,0,3.1512441804359005e-4,1,0,0.18813319768365563,2015-01-01,2,291917,1
Bangladesh,201501,3,4050,1350,2356,0,0,0,0,-1,3,0,0,4.879266500672873e-8,1,0,0.002610123598895595,2015-01-01,3,4050,1
Ecuador,201501,4,3461,865.25,2788,0,0,0,0,-1,4,0,3,1.238994120453357e-5,1,0,0.0022305278458710255,2015-01-01,4,3461,1
India,201501,10,456804,45680.4,247057,0,0,0,0,-1,10,0,4,7.74830970278178e-6,1,0,0.29439874085676626,2015-01-01,10,456804,1
Slovenia,201501,4,25134,6283.5,21603,12,252414,21034.5,136964,0.8188853819879804,16,832,39,0.003861452429343073,1,0.1626745032325019,0.016198233712257256,2015-01-01,-8,277548,1
Croatia,201501,1,564,564,564,6,189784,31630.6666666667,100209,0.9940740118099481,7,0,14,0.0034672678187652687,1,0.12231103631921027,3.634838789573125e-4,2015-01-01,-5,190348,1
Viet Nam,201501,5,21644,4328.8,14315,0,0,0,0,-1,5,0,2,6.417416416808133e-8,1,0,0.013949016092468212,2015-01-01,5,21644,1
Cyprus,201501,2,366183,183091.5,356619,2,29450,14725,29322,-0.851124653403533,4,43,2,1.7989392050520354e-4,2,0.01897978765122846,0.23599577526281126,2015-01-01,0,395633,1
Peru,201501,2,1313,656.5,727,0,0,0,0,-1,2,0,0,4.043620182373289e-6,1,0,8.46195626012325e-4,2015-01-01,2,1313,1
Suriname,201501,1,1209,1209,1209,0,0,0,0,-1,1,0,0,1.3444613228266877e-5,1,0,7.791702298925368e-4,2015-01-01,1,1209,1
Egypt,201501,7,133441,19063,43438,0,0,0,0,-1,7,0,7,9.107827960680533e-4,1,0,0.08599938349635236,2015-01-01,7,133441,1
Afghanistan,201501,1,20197,20197,20197,0,0,0,0,-1,1,0,0,4.92542804403673e-10,2,0,0.01301646082145539,2015-01-01,1,20197,1
Algeria,201501,1,4184,4184,4184,0,0,0,0,-1,1,0,0,1.0640909918759213e-4,1,0,0.002696483243896091,2015-01-01,1,4184,1
Brazil,201501,3,17302,5767.33333333333,15669,0,0,0,0,-1,3,0,0,2.2651590431050686e-7,1,0,0.011150705804467058,2015-01-01,3,17302,1
Colombia,201501,3,1516,505.333333333333,663,0,0,0,0,-1,3,0,0,7.861243810512691e-6,1,0,9.770240434384498e-4,2015-01-01,3,1516,1
Costa Rica,201501,3,2777,925.666666666667,1528,0,0,0,0,-1,3,0,0,9.365639938415977e-6,1,0,0.0017897069713908808,2015-01-01,3,2777,1
Kenya,201501,2,678,339,639,0,0,0,0,-1,2,0,1,1.366921262129454e-9,1,0,4.369540247040033e-4,2015-01-01,2,678,1
Malaysia,201501,3,919344,306448,918102,11,336205,30564.0909090909,285104,-0.46444941615181884,14,101,15,1.8629788881774863e-6,1,0.21667570483128235,0.5924941900995239,2015-01-01,-8,1255549,1
Saudi Arabia,201501,3,161627,53875.6666666667,150079,0,0,0,0,-1,3,0,0,3.355593449989282e-7,1,0,0.10416455479474032,2015-01-01,3,161627,1
Uganda,201501,1,964,964,964,2,52,26,39,-0.8976377952755905,3,1,1,2.0621458920016287e-9,1,3.3512698059894055e-5,6.212738640334206e-4,2015-01-01,-1,1016,1
Dominica,201501,2,307,153.5,235,0,0,0,0,-1,2,0,0,3.525442062059296e-13,1,0,1.97853813545913e-4,2015-01-01,2,307,1
Mexico,201501,2,12612112,6306056,12611728,0,0,0,0,-1,2,0,0,0.013614904762889705,1,0,8.12819041064551,2015-01-01,2,12612112,1
Luxembourg,201501,2,396,198,273,8,105999,13249.875,42256,0.9925560411673481,10,150,19,0.0014015028100287535,1,0.06831370157020597,2.5521208522534707e-4,2015-01-01,-6,106395,1
Thailand,201501,4,345139,86284.75,285104,0,0,0,0,-1,4,0,4,2.119675441947267e-5,1,0,0.2224334441479572,2015-01-01,4,345139,1
China,201501,7,4846599,692371.285714286,3825824,0,0,0,0,-1,7,0,4,0.0011688748353570878,2,0,3.1235117096997014,2015-01-01,7,4846599,1
Indonesia,201501,2,15217,7608.5,10104,0,0,0,0,-1,2,0,1,8.067686835418464e-9,1,0,0.009806975507257844,2015-01-01,2,15217,1
Japan,201501,3,37597,12532.3333333333,33457,1,12722,12722,12722,-0.49434607206025555,4,4,2,1.1312771833682916e-7,1,0.008199010475345618,0.024230325172266094,2015-01-01,2,50319,1
Singapore,201501,1,315,315,315,12,1056492,88041,918102,0.9994038646602454,13,17,14,3.045285009216654e-5,1,0.6808826422825691,2.0300961324743515e-4,2015-01-01,-11,1056807,1
Georgia,201501,1,527,527,527,2,437581,218790.5,431895,0.9975942005167675,3,1,2,1.4416640771357751e-4,2,0.2820099986489712,3.3963830533777244e-4,2015-01-01,-1,438108,1
Denmark,201501,4,165192,41298,156560,21,3269351,155683.380952381,2552432,0.9038055426879209,25,812,110,0.07542602762032026,1,2.107014863746398,0.10646210803673113,2015-01-01,-17,3434543,1
Azerbaijan,201501,1,2445,2445,2445,1,425103,425103,425103,0.9885626876982233,2,0,1,5.8566309471892836e-5,2,0.273968240064522,0.001575741283777711,2015-01-01,0,427548,1
Belize,201501,1,91753,91753,91753,0,0,0,0,-1,1,0,0,2.8002825830516835e-5,2,0,0.05913251125172037,2015-01-01,1,91753,1
Belarus,201501,1,657427,657427,657427,9,4202100,466900,1167200,0.7294275759760158,10,4,9,0.021503597128819215,2,2.708148240720785,0.4236952412965764,2015-01-01,-8,4859527,1
Uzbekistan,201501,2,1071715,535857.5,1070388,0,0,0,0,-1,2,0,1,1.0650839405246725e-6,2,0,0.6906934846396031,2015-01-01,2,1071715,1
Zimbabwe,201501,1,305,305,305,0,0,0,0,-1,1,0,0,0,1,0,1.9656486362053244e-4,2015-01-01,1,305,1
Kyrgyzstan,201501,1,11330,11330,11330,1,90088,90088,90088,0.776568262044213,2,1,1,2.6850577217842858e-6,2,0.058059460438841075,0.007301901327280763,2015-01-01,0,101418,1
Turkmenistan,201501,1,1200,1200,1200,0,0,0,0,-1,1,0,0,7.40015344862452e-10,2,0,7.733699552283244e-4,2015-01-01,1,1200,1
Argentina,201501,1,54,54,54,0,0,0,0,-1,1,0,0,5.8295330905272576e-8,1,0,3.48016479852746e-5,2015-01-01,1,54,1
Canada,201501,1,10737,10737,10737,21,15663951,745902.428571429,12611728,0.9986300205784,22,0,8,0.042447578607171806,1,10.095024236307223,0.006919727674405432,2015-01-01,-20,15674688,1
Chile,201501,1,4351,4351,4351,0,0,0,0,-1,1,0,0,4.697092310834006e-6,1,0,0.0028041105626653664,2015-01-01,1,4351,1
Rep. of Korea,201501,1,12722,12722,12722,0,0,0,0,-1,1,0,0,3.660256487014544e-11,1,0,0.008199010475345618,2015-01-01,1,12722,1
Ghana,201501,1,2001,2001,2001,0,0,0,0,-1,1,0,0,2.174377525742234e-5,1,0,0.001289594400343231,2015-01-01,1,2001,1
Ireland,201501,1,13222,13222,13222,0,0,0,0,-1,1,0,0,1.436762600967682e-4,1,0,0.008521247956690754,2015-01-01,1,13222,1
Seychelles,201501,0,0,0,0,9,10611,1179,3116,1,9,0,2,3.56316579422502e-5,1,0.006838523829106459,0,2015-01-01,-9,10611,1
Cabo Verde,201501,0,0,0,0,1,1215,1215,1215,1,1,0,0,3.090034787593909e-5,1,7.830370796686784e-4,0,2015-01-01,-1,1215,1
Barbados,201501,0,0,0,0,3,749,249.666666666667,424,1,3,0,0,1.6149643003596743e-7,1,4.827117470550125e-4,0,2015-01-01,-3,749,1
El Salvador,201501,0,0,0,0,2,74313,37156.5,69589,1,2,0,1,3.838157759872832e-8,1,0.04789286790240206,0,2015-01-01,-2,74313,1
Iceland,201501,0,0,0,0,2,718,359,540,1,2,0,1,1.0532002711257644e-5,1,4.627330232116141e-4,0,2015-01-01,-2,718,1
Panama,201501,0,0,0,0,1,357,357,357,1,1,0,0,1.0751403266804322e-8,1,2.300775616804265e-4,0,2015-01-01,-1,357,1
Switzerland,201501,0,0,0,0,11,2830917,257356.090909091,2660170,1,11,0,15,0.06826398146138632,1,1.824455127954252,0,2015-01-01,-11,2830917,1
Malta,201501,0,0,0,0,2,32609,16304.5,29169,1,2,0,1,7.196595658634569e-5,1,0.021015684058367026,0,2015-01-01,-2,32609,1
Pakistan,201501,0,0,0,0,3,273946,91315.3333333333,247057,1,3,0,0,9.588927193401172e-7,2,0.1765513381291488,0,2015-01-01,-3,273946,1
Nicaragua,201501,0,0,0,0,1,1814,1814,1814,1,1,0,0,1.2792205215944258e-10,1,0.0011690775823201504,0,2015-01-01,-1,1814,1
Qatar,201501,0,0,0,0,13,205424,15801.8461538462,150079,1,13,0,2,8.411140759631985e-5,1,0.13239062473568608,0,2015-01-01,-13,205424,1
Bosnia Herzegovina,201501,0,0,0,0,4,55919,13979.75,41509,1,4,0,1,0.0010638441162790645,1,0.03603839543867723,0,2015-01-01,-4,55919,1
Antigua and Barbuda,201501,0,0,0,0,3,2434,811.333333333333,1978,1,3,0,0,1.9253304793241366e-7,1,0.001568652059188118,0,2015-01-01,-3,2434,1
"China, Hong Kong SAR",201501,0,0,0,0,9,311605,34622.7777777778,251617,1,9,0,5,1.2919314232498846e-4,1,0.20082162074910168,0,2015-01-01,-9,311605,1
Mauritius,201501,0,0,0,0,1,4433,4433,4433,1,1,0,0,1.0268325820700504e-7,1,0.0028569575096059683,0,2015-01-01,-1,4433,1
Paraguay,201501,0,0,0,0,1,15669,15669,15669,1,1,0,0,9.026659671756198e-11,1,0.010098278190393845,0,2015-01-01,-1,15669,1
Montserrat,201501,0,0,0,0,1,235,235,235,1,1,0,0,-0,1,1.5145161623221352e-4,0,2015-01-01,-1,235,1
Armenia,201501,0,0,0,0,3,146903,48967.6666666667,145937,1,3,0,2,1.9997207477780875e-5,2,0.09467530544408878,0,2015-01-01,-3,146903,1
Mozambique,201501,0,0,0,0,2,3459,1729.5,3154,1,2,0,0,8.922919810193439e-14,1,0.002229238895945645,0,2015-01-01,-2,3459,1
Ethiopia,201501,0,0,0,0,1,126,126,126,1,1,0,0,3.745636639934877e-9,2,8.120384529897406e-5,0,2015-01-01,-1,126,1
Bermuda,201501,0,0,0,0,2,17064,8532,16939,1,2,0,0,1.868441309929773e-6,1,0.010997320763346773,0,2015-01-01,-2,17064,1
Rep. of Moldova,201501,0,0,0,0,2,227107,113553.5,226933,1,2,0,1,7.538996374528997e-5,1,0.14636477535169923,0,2015-01-01,-2,227107,1
Kuwait,201501,0,0,0,0,5,398884,79776.8,199990,1,5,0,0,1.6472263439390119e-6,1,0.2570707510177458,0,2015-01-01,-5,398884,1
Botswana,201501,0,0,0,0,1,39248,39248,39248,1,1,0,0,1.1103880488900082e-12,1,0.02529435333566773,0,2015-01-01,-1,39248,1
Zambia,201501,0,0,0,0,2,799,399.5,758,1,2,0,0,8.835315731237356e-14,1,5.14935495189526e-4,0,2015-01-01,-2,799,1
Saint Vincent and the Grenadines,201501,0,0,0,0,1,307,307,307,1,1,0,0,9.245604488571769e-9,1,1.97853813545913e-4,0,2015-01-01,-1,307,1
Kazakhstan,201501,0,0,0,0,10,1752716,175271.6,1070388,1,10,0,12,2.424780254930306e-5,2,1.1295815787066399,0,2015-01-01,-10,1752716,1
Montenegro,201501,0,0,0,0,6,41473,6912.16666666667,32309,1,6,0,7,4.004531977682583e-5,1,0.02672831012765358,0,2015-01-01,-6,41473,1
Norway,201501,0,0,0,0,6,2590828,431804.666666667,2535618,1,6,0,7,0.06468861602116555,1,1.6697237786369077,0,2015-01-01,-6,2590828,1
Ukraine,201501,0,0,0,0,3,2559968,853322.666666667,2347466,1,3,0,0,0.005605814319279587,2,1.649835281288286,0,2015-01-01,-3,2559968,1
Greenland,201501,0,0,0,0,3,12557,4185.66666666667,7076,1,3,0,3,1.769638386254427e-5,1,0.008092672106501725,0,2015-01-01,-3,12557,1
Greece,201502,15,5082659,338843.933333333,2676168,3,15886,5295.33333333333,15661,-0.993768418244813,18,162,52,0.06117015526273877,1,0.01042856718694451,3.3365762853977206,2015-02-01,12,5098545,2
Italy,201502,22,1560172,70916.9090909091,1033032,7,1729446,247063.714285714,1532225,0.051457038476807944,29,316,86,0.049769900569410115,1,1.1353168706529293,1.0241947957440254,2015-02-01,15,3289618,2
Egypt,201502,8,98052,12256.5,52179,0,0,0,0,-1,8,0,5,0.001124204406970924,1,0,0.06436748519540998,2015-02-01,8,98052,2
Estonia,201502,4,37217,9304.25,24059,6,102288,17048,52734,0.46644206300849433,10,135,25,0.0014103379209198168,1,0.06714826138852951,0.024431574027226097,2015-02-01,-2,139505,2
Finland,201502,2,40847,20423.5,40845,7,1717978,245425.428571429,964926,0.9535519451906813,9,74,21,0.03687300947661357,1,1.127788555878922,0.026814533796117486,2015-02-01,-5,1758825,2
Germany,201502,21,9132322,434872.476190476,1691298,31,38121269,1229718.35483871,26920941,0.6134760636498504,52,2050,165,0.8349409762049733,1,25.025192938315808,5.9950291797690705,2015-02-01,-10,47253591,2
Lithuania,201502,4,37358,9339.5,36639,9,1552529,172503.222222222,1014919,0.9530054651682792,13,0,34,0.030230400060575147,1,1.0191774509744285,0.0245241352744475,2015-02-01,-5,1589887,2
Netherlands,201502,31,13992378,451367.032258065,5969736,10,14037737,1403773.7,11844860,0.0016182238281933557,41,1056,160,0.5148035335379663,1,9.215251382170267,9.185474888463064,2015-02-01,21,28030115,2
Poland,201502,10,277513,27751.3,170011,6,6446610,1074435,4767074,0.9174574885081668,16,0,57,0.1483513801297716,1,4.231959304609615,0.18217694610037338,2015-02-01,4,6724123,2
Spain,201502,39,90406569,2318117.15384615,26920941,11,2318782,210798.363636364,1865611,-0.9499860183867085,50,458,166,1,1,1.5221939996775502,59.34854456487692,2015-02-01,28,92725351,2
Turkey,201502,25,6534582,261383.28,3357968,0,0,0,0,-1,25,0,73,0.008919294438167342,1,0,4.289709645322814,2015-02-01,25,6534582,2
France,201502,18,993413,55189.6111111111,273313,16,7866814,491675.875,6673068,0.7757590183637507,34,2248,101,0.19189105562917355,1,5.16427032268637,0.6521386261415149,2015-02-01,2,8860227,2
Honduras,201502,5,156624,31324.8,88904,0,0,0,0,-1,5,0,4,5.905643442213746e-6,2,0,0.10281782116882769,2015-02-01,5,156624,2
Iran,201502,7,13633479,1947639.85714286,12870414,0,0,0,0,-1,7,0,4,0.0020089399420331225,3,0,8.949871065296302,2015-02-01,7,13633479,2
Armenia,201502,2,67303,33651.5,36567,2,154994,77497,153184,0.39447675857074094,4,1,4,1.3135302456122375e-5,3,0.10174778689243845,0.044181912210935814,2015-02-01,0,222297,2
New Zealand,201502,2,2454,1227,2005,0,0,0,0,-1,2,0,0,6.2941698877364e-11,3,0,0.0016109595793001275,2015-02-01,2,2454,2
United States of America,201502,8,739469,92433.625,699860,0,0,0,0,-1,8,0,2,3.177026895457046e-4,3,0,0.485433850507533,2015-02-01,8,739469,2
Guatemala,201502,3,6920,2306.66666666667,4002,1,11790,11790,11790,0.2602886157135222,4,2,3,1.208487248946309e-8,2,0.0077396957783001236,0.004542722204057409,2015-02-01,2,18710,2
Bosnia Herzegovina,201502,1,300400,300400,300400,3,61924,20641.3333333333,49456,-0.6581843874543226,4,0,3,0.001343384123849175,1,0.040650799098851303,0.19720140897382163,2015-02-01,-2,362324,2
Mexico,201502,4,6687045,1671761.25,6686393,0,0,0,0,-1,4,0,0,5.214184441454228e-4,2,0,4.389795925004491,2015-02-01,4,6687045,2
Morocco,201502,9,2772255,308028.333333333,1865611,0,0,0,0,-1,9,0,19,0.05315317058162027,4,0,1.819882130608262,2015-02-01,9,2772255,2
Russian Federation,201502,3,18497,6165.66666666667,14900,15,21051569,1403437.93333333,12870414,0.9982442390071299,18,525,27,0.006010735139031365,4,13.819570798633906,0.012142591417406055,2015-02-01,-12,21070066,2
Serbia,201502,1,44e3,44e3,44e3,4,269512,67378,151494,0.7193089897675368,5,0,5,0.004034498556828043,4,0.17692458766761857,0.028884360835047113,2015-02-01,-3,313512,2
Ukraine,201502,4,842932,210733,667700,3,738928,246309.333333333,700620,-0.06574791700909056,7,180,14,0.0018888506099914066,1,0.48507870416181115,0.5533534556229075,2015-02-01,1,1581860,2
TFYR of Macedonia,201502,4,670192,167548,485900,1,56005,56005,56005,-0.8457581069599571,5,56,3,2.1856141606580899e-4,4,0.03676519610379121,0.4399560808354976,2015-02-01,3,726197,2
Bulgaria,201502,6,1160318,193386.333333333,958602,4,722371,180592.75,438496,-0.23261781420085845,10,624,23,0.02350491093368412,1,0.4742096504721322,0.7617055408045499,2015-02-01,2,1882689,2
Slovakia,201502,3,15160,5053.33333333333,12668,9,1020004,113333.777777778,600998,0.9707099551375434,12,89,39,0.022062006537303527,1,0.6695946270270772,0.009951975233166231,2015-02-01,-6,1035164,2
Hungary,201502,7,8257,1179.57142857143,4750,8,1028596,128574.5,616789,0.9840729592333726,15,240,56,0.023836729277779727,1,0.6752349549428663,0.005420412895795091,2015-02-01,-1,1036853,2
United Kingdom,201502,9,496805,55200.5555555556,198073,13,18492040,1422464.61538462,13840237,0.947674015981488,22,746,54,0.42700825822054567,1,12.13933536218465,0.3261339746512632,2015-02-01,-4,18988845,2
Austria,201502,8,71716,8964.5,35580,11,4178005,379818.636363636,1412167,0.966249078468916,19,105,62,0.0590025185537814,1,2.742704636150705,0.04707888231014179,2015-02-01,-3,4249721,2
Belgium,201502,9,1158527,128725.222222222,592036,7,3834206,547743.714285714,1554224,0.5359146984226876,16,11,39,0.09379709924039559,1,2.5170134004523326,0.7605298160260142,2015-02-01,2,4992733,2
Czech Rep.,201502,5,40808,8161.6,22424,10,3967421,396742.1,2528409,0.9796378899508985,15,0,56,0.08031633526093272,1,2.604464085194169,0.026788931749013693,2015-02-01,-5,4008229,2
Jordan,201502,10,390108,39010.8,142674,0,0,0,0,-1,10,0,20,0.002757234783423934,1,0,0.2560913690145127,2015-02-01,10,390108,2
Portugal,201502,6,8080,1346.66666666667,5469,2,506553,253276.5,506411,0.9685989821873063,8,1133,9,0.013033257373381185,1,0.3325331735017186,0.005304218989708651,2015-02-01,4,514633,2
Romania,201502,4,1630,407.5,881,10,1927388,192738.8,878081,0.9983100209536666,14,384,51,0.016074070352733758,1,1.2652584195713588,0.0010700342763892453,2015-02-01,-6,1929018,2
Sweden,201502,3,30380,10126.6666666667,18317,7,7463616,1066230.85714286,5550743,0.9918921760833606,10,0,19,0.16798113034854137,1,4.899585856323431,0.019943338231107527,2015-02-01,-4,7493996,2
Latvia,201502,2,154504,77252,107337,8,876507,109563.375,708049,0.7002864178946684,10,0,20,0.018656277347070878,1,0.5753941923282873,0.10142612014677543,2015-02-01,-6,1031011,2
Albania,201502,1,436,436,436,0,0,0,0,-1,1,0,0,1.0215312367628467e-9,1,0,2.8621775736546685e-4,2015-02-01,1,436,2
Dominican Rep.,201502,4,58167,14541.75,57329,0,0,0,0,-1,4,0,3,1.3959711642943116e-5,1,0,0.03818446856118603,2015-02-01,4,58167,2
Israel,201502,7,92943,13277.5714285714,65407,0,0,0,0,-1,7,0,10,0.0015317584382527345,1,0,0.06101361702481326,2015-02-01,7,92943,2
Thailand,201502,5,245306,49061.2,198959,0,0,0,0,-1,5,0,2,1.1884394925823414e-5,1,0,0.16103425043186514,2015-02-01,5,245306,2
Croatia,201502,1,581,581,581,5,185558,37111.6,104061,0.9937573533757031,6,0,10,0.0035688959320606386,1,0.12181191426885618,3.814048555718721e-4,2015-02-01,-4,186139,2
Kenya,201502,2,595,297.5,571,0,0,0,0,-1,2,0,0,5.9217763769804436e-8,1,0,3.9059533401938706e-4,2015-02-01,2,595,2
India,201502,7,154942,22134.5714285714,123348,0,0,0,0,-1,7,0,4,2.1803017704647725e-6,1,0,0.10171365082963339,2015-02-01,7,154942,2
Canada,201502,2,6837,3418.5,5611,17,7735278,455016.352941176,6686393,0.9982338159533926,19,287,10,0.0030328393533130688,2,5.07792183889549,0.0044882357961185705,2015-02-01,-15,7742115,2
Chile,201502,1,72,72,72,1,2921,2921,2921,0.9518877380554628,2,1,0,1.1270798104077144e-8,2,0.0019175276817993776,4.7265317730077094e-5,2015-02-01,0,2993,2
Costa Rica,201502,3,2241,747,1529,0,0,0,0,-1,3,0,1,5.210413407828787e-6,2,0,0.0014711330143486493,2015-02-01,3,2241,2
Dominica,201502,3,758,252.666666666667,364,0,0,0,0,-1,3,0,0,7.018397836504195e-9,2,0,4.975987616583116e-4,2015-02-01,3,758,2
Ecuador,201502,1,134,134,134,0,0,0,0,-1,1,0,0,1.0449160514732417e-8,2,0,8.796600799764347e-5,2015-02-01,1,134,2
United Rep. of Tanzania,201502,1,10757,10757,10757,0,0,0,0,-1,1,0,0,8.388180568753619e-7,2,0,0.007061569761422768,2015-02-01,1,10757,2
Norway,201502,1,4955,4955,4955,8,2040796,255099.5,1956899,0.995155813195252,9,14,11,0.0509503235034548,1,1.3397065466982,0.0032527729076740554,2015-02-01,-7,2045751,2
Lebanon,201502,5,7390,1478,2735,0,0,0,0,-1,5,0,3,2.7898632404563083e-5,5,0,0.004851259694795412,2015-02-01,5,7390,2
Peru,201502,3,7154,2384.66666666667,3292,0,0,0,0,-1,3,0,1,7.53139647353833e-5,2,0,0.00469633448668016,2015-02-01,3,7154,2
Switzerland,201502,1,473,473,473,13,2964312,228024,2664673,0.9996809212135113,14,2009,25,0.07043987508199293,1,1.9459603962650038,3.1050687897675645e-4,2015-02-01,-12,2964785,2
Denmark,201502,5,142073,28414.6,132149,21,3956289,188394.714285714,3114095,0.9306683987407652,26,1157,115,0.0939382781481909,1,2.5971563419029025,0.09326563174812837,2015-02-01,-16,4098362,2
Oman,201502,2,19483,9741.5,18731,0,0,0,0,-1,2,0,0,4.963120931266071e-9,3,0,0.01278986368520961,2015-02-01,2,19483,2
Saudi Arabia,201502,3,176862,58954,140120,0,0,0,0,-1,3,0,0,9.924837001701333e-8,3,0,0.11610331422745687,2015-02-01,3,176862,2
South Africa,201502,7,50914,7273.42857142857,40155,0,0,0,0,-1,7,0,0,1.4622994760826185e-5,5,0,0.03342314426262701,2015-02-01,7,50914,2
Uganda,201502,1,582,582,582,1,24,24,24,-0.9207920792079208,2,1,0,1.0760007179860259e-10,1,1.5755105910025698e-5,3.8206131831812316e-4,2015-02-01,0,606,2
Cyprus,201502,2,147994,73997,137098,3,45782,15260.6666666667,40205,-0.5274750227066304,5,0,3,1.0145860387059952e-4,4,0.030054177448866518,0.09715254766868096,2015-02-01,-1,193776,2
Slovenia,201502,2,36090,18045,33834,10,245657,24565.7,133876,0.743812711404203,12,157,25,0.004033561648727285,1,0.16126466885579926,0.023691740512201142,2015-02-01,-8,281747,2
Suriname,201502,1,2088,2088,2088,0,0,0,0,-1,1,0,0,2.7637528848013653e-5,1,0,0.0013706942141722357,2015-02-01,1,2088,2
Malaysia,201502,3,654853,218284.333333333,654254,9,208327,23147.4444444444,198959,-0.517303459301652,12,79,12,2.5807932569333994e-6,3,0.13675891453824682,0.4298865987707524,2015-02-01,-6,863180,2
Australia,201502,5,14245,2849,6093,0,0,0,0,-1,5,0,2,3.0858593154613748e-9,3,0,0.009351311820346502,2015-02-01,5,14245,2
Rep. of Korea,201502,1,2236,2236,2236,0,0,0,0,-1,1,0,0,3.1344685478621847e-10,3,0,0.001467850700617394,2015-02-01,1,2236,2
China,201502,6,4486472,747745.333333333,3430401,0,0,0,0,-1,6,0,3,5.307738716474137e-4,3,0,2.9452017300985336,2015-02-01,6,4486472,2
Japan,201502,3,40760,13586.6666666667,36310,0,0,0,0,-1,3,0,2,7.5737532618041755e-09,3,0,0.02675742153719364,2015-02-01,3,40760,2
Bangladesh,201502,3,5968,1989.33333333333,5270,0,0,0,0,-1,3,0,1,8.48204331353874e-8,3,0,0.00391776966962639,2015-02-01,3,5968,2
Indonesia,201502,1,8,8,8,0,0,0,0,-1,1,0,0,5.308461616806205e-13,3,0,5.251701970008565e-6,2015-02-01,1,8,2
Brazil,201502,2,30234,15117,30026,0,0,0,0,-1,2,0,0,4.465258075205641e-6,1,0,0.019847494670154873,2015-02-01,2,30234,2
Saint Kitts and Nevis,201502,1,87,87,87,0,0,0,0,-1,1,0,0,-0,2,0,5.711225892384315e-5,2015-02-01,1,87,2
Luxembourg,201502,1,316,316,316,9,167956,18661.7777777778,57357,0.9962441760958448,10,175,21,0.0020952348873237033,1,0.11025685700934483,2.0744222781533835e-4,2015-02-01,-8,168272,2
Colombia,201502,1,23,23,23,0,0,0,0,-1,1,0,0,4.937542044240295e-7,1,0,1.5098643163774626e-5,2015-02-01,1,23,2
Belize,201502,1,123153,123153,123153,0,0,0,0,-1,1,0,0,1.90326728413902e-5,4,0,0.08084535658905811,2015-02-01,1,123153,2
Belarus,201502,2,583525,291762.5,579024,9,2564100,284900,667700,0.6292283864818713,11,141,14,0.00831524644346059,4,1.6832361276623704,0.38306242400615603,2015-02-01,-7,3147625,2
Kazakhstan,201502,1,56451,56451,56451,9,2020643,224515.888888889,1173509,0.9456442510545984,10,283,9,2.369973537299343e-5,4,1.3264768529730022,0.03705797848861919,2015-02-01,-8,2077094,2
Uzbekistan,201502,2,1173999,586999.5,1173509,0,0,0,0,-1,2,0,1,7.908111122794081e-7,4,0,0.7706866076360107,2015-02-01,2,1173999,2
Algeria,201502,1,8267,8267,8267,0,0,0,0,-1,1,0,0,1.497247891430247e-5,1,0,0.005426977523257602,2015-02-01,1,8267,2
Ireland,201502,1,7374,7374,7374,9,936571,104063.444444444,340136,0.9843762083595973,10,0,21,0.01845112669552642,1,0.6148239707191115,0.004840756290855395,2015-02-01,-8,943945,2
United Arab Emirates,201502,1,7442,7442,7442,0,0,0,0,-1,1,0,0,1.4787186496903723e-8,5,0,0.004885395757600468,2015-02-01,1,7442,2
Kyrgyzstan,201502,1,141,141,141,1,47392,47392,47392,0.9940672795741906,2,0,1,6.468438574635897e-7,3,0.03111108247033074,9.256124722140097e-5,2015-02-01,0,47533,2
Turkmenistan,201502,1,5084,5084,5084,0,0,0,0,-1,1,0,0,3.09796305805045e-9,4,0,0.0033374566019404436,2015-02-01,1,5084,2
Georgia,201502,0,0,0,0,3,321625,107208.333333333,262691,1,3,0,2,6.141015526441577e-5,3,0.2111348307630006,0,2015-02-01,-3,321625,2
New Caledonia,201502,0,0,0,0,1,2005,2005,2005,1,1,0,0,3.2487044180652817e-15,3,0.0013162078062333967,0,2015-02-01,-1,2005,2
Barbados,201502,0,0,0,0,1,430,430,430,1,1,0,0,3.512501695259263e-9,3,2.822789808879604e-4,0,2015-02-01,-1,430,2
El Salvador,201502,0,0,0,0,2,92906,46453,88904,1,2,0,1,1.3500682454972755e-8,2,0.060989327903201974,0,2015-02-01,-2,92906,2
Azerbaijan,201502,0,0,0,0,1,568550,568550,568550,1,1,0,0,2.936721838587925e-5,3,0.37323189438104626,0,2015-02-01,-1,568550,2
Iceland,201502,0,0,0,0,2,920,460,875,1,2,0,1,1.273883575964301e-5,1,6.03945726550985e-4,0,2015-02-01,-2,920,2
Montenegro,201502,0,0,0,0,5,45556,9111.2,41210,1,5,0,3,9.112508949473631e-5,1,0.029905816868213777,0,2015-02-01,-5,45556,2
Nicaragua,201502,0,0,0,0,3,7827,2609,3512,1,3,0,1,7.389741115527601e-10,2,0.0051381339149071305,0,2015-02-01,-3,7827,2
Qatar,201502,0,0,0,0,11,180619,16419.9090909091,140120,1,11,0,5,7.188112652803084e-6,1,0.11856964476512213,0,2015-02-01,-11,180619,2
Antigua and Barbuda,201502,0,0,0,0,3,5061,1687,4727,1,3,0,0,3.9015260968085555e-8,2,0.003322357958776669,0,2015-02-01,-3,5061,2
Malta,201502,0,0,0,0,2,17706,8853,15266,1,2,0,1,5.1831990499397866e-5,1,0.011623329385121457,0,2015-02-01,-2,17706,2
"China, Hong Kong SAR",201502,0,0,0,0,9,237545,26393.8888888889,189705,1,9,0,6,5.452113927014943e-6,3,0.1559394430582106,0,2015-02-01,-9,237545,2
Rep. of Moldova,201502,0,0,0,0,3,122578,40859.3333333333,122379,1,3,0,2,2.834960085760432e-5,1,0.08046789050996374,0,2015-02-01,-3,122578,2
Mauritius,201502,0,0,0,0,2,4188,2094,2118,1,2,0,0,6.062960521231421e-8,5,0.0027492659812994842,0,2015-02-01,-2,4188,2
Paraguay,201502,0,0,0,0,1,30026,30026,30026,1,1,0,0,3.4472377726853306e-9,1,0.01971095041893465,0,2015-02-01,-1,30026,2
Singapore,201502,0,0,0,0,6,736712,122785.333333333,654254,1,6,0,4,2.1938564913094197e-5,3,0.4836239827161188,0,2015-02-01,-6,736712,2
Montserrat,201502,0,0,0,0,2,451,225.5,364,1,2,0,0,6.568146754911017e-14,2,2.960646985592329e-4,0,2015-02-01,-2,451,2
Cabo Verde,201502,0,0,0,0,1,777,777,777,1,1,0,0,1.9977825445330088e-5,1,5.10071553837082e-4,0,2015-02-01,-1,777,2
Ethiopia,201502,0,0,0,0,1,3,3,3,1,1,0,0,1.1279370743376768e-12,5,1.9693882387532122e-6,0,2015-02-01,-1,3,2
Mozambique,201502,0,0,0,0,1,5421,5421,5421,1,1,0,0,2.0381818400815174e-9,5,0.003558684547427054,0,2015-02-01,-1,5421,2
Bermuda,201502,0,0,0,0,1,19384,19384,19384,1,1,0,0,1.583403089286207e-7,3,0.012724873873330754,0,2015-02-01,-1,19384,2
Greenland,201502,0,0,0,0,3,12799,4266.33333333333,7117,1,3,0,3,2.449887188343704e-5,1,0.008402066689267454,0,2015-02-01,-3,12799,2
Kuwait,201502,0,0,0,0,8,177517,22189.625,123348,1,8,0,3,7.764724569218e-5,3,0.11653329732625131,0,2015-02-01,-8,177517,2
Solomon Isds,201502,0,0,0,0,1,71,71,71,1,1,0,0,5.635454196176146e-15,3,4.660885498382602e-5,0,2015-02-01,-1,71,2
Botswana,201502,0,0,0,0,1,40155,40155,40155,1,1,0,0,1.509743436030924e-8,5,0.026360261575711745,0,2015-02-01,-1,40155,2
Seychelles,201502,0,0,0,0,9,17553,1950.33333333333,7442,1,9,0,4,7.728028041889526e-5,5,0.011522890584945045,0,2015-02-01,-9,17553,2
Saint Vincent and the Grenadines,201502,0,0,0,0,1,651,651,651,1,1,0,0,5.317764192829955e-9,3,4.27357247809447e-4,0,2015-02-01,-1,651,2
Austria,201503,7,87545,12506.4285714286,55168,12,3283892,273657.666666667,841809,0.9480666552570907,19,138,62,0.043656284029723186,1,2.2003122080374315,0.05865793767049493,2015-03-01,-5,3371437,3
Belgium,201503,14,3080826,220059,1590356,8,5928666,741083.25,4701409,0.3160932936063432,22,532,77,0.14792400106184023,1,3.972395004822463,2.0642515218646436,2015-03-01,6,9009492,3
France,201503,17,1424540,83796.4705882353,395443,15,7370318,491354.533333333,5588542,0.6760516201625996,32,820,113,0.14200171593460426,1,4.938347750936397,0.954487161221393,2015-03-01,2,8794858,3
Germany,201503,25,8067064,322682.56,1538518,27,55352936,2050108.74074074,29990664,0.745598738568275,52,1149,166,1,1,37.088229707771944,5.405189757220784,2015-03-01,-2,6342e4,3
Netherlands,201503,35,35944572,1026987.77142857,20931201,12,5413830,451152.5,4178309,-0.738199266016129,47,780,167,0.6580797439828915,1,3.627438491046383,24.084007812766203,2015-03-01,23,41358402,3
Spain,201503,35,75220247,2149149.91428571,29990664,12,1338416,111534.666666667,1133687,-0.9650355440507105,47,177,153,0.9142836605469273,1,0.8967813387993963,50.399960706896266,2015-03-01,23,76558663,3
Armenia,201503,2,726823,363411.5,627734,2,29334,14667,29122,-0.9224129380538698,4,1,4,3.332906053885939e-5,2,0.019654714074205246,0.4869945540177296,2015-03-01,0,756157,3
Iran,201503,9,7171820,796868.888888889,6212020,0,0,0,0,-1,9,0,6,3.5788443435362353e-4,2,0,4.805347770221132,2015-03-01,9,7171820,3
Turkey,201503,24,4878488,203270.333333333,2015323,0,0,0,0,-1,24,0,62,0.006182216096453326,1,0,3.2687423043035864,2015-03-01,24,4878488,3
Bulgaria,201503,5,1327765,265553,1099718,5,883589,176717.8,439058,-0.20086155360019245,10,47,13,0.029145174396955128,1,0.5920327658728076,0.8896448296426376,2015-03-01,0,2211354,3
Colombia,201503,1,329,329,329,0,0,0,0,-1,1,0,0,7.723158131387933e-6,1,0,2.2044047625327355e-4,2015-03-01,1,329,3
Costa Rica,201503,3,252,84,170,0,0,0,0,-1,3,0,1,3.998581550060714e-6,1,0,1.6884802436420952e-4,2015-03-01,3,252,3
Czech Rep.,201503,6,84597,14099.5,51331,9,4136697,459633,2631873,0.9599189253342696,15,103,52,0.07962932485490881,1,2.771718713664097,0.05668268379817076,2015-03-01,-3,4221294,3
Denmark,201503,5,109397,21879.4,95048,20,3448930,172446.5,2562268,0.9385121153845614,25,712,116,0.07061188607058484,1,2.310892923295449,0.07329947349750567,2015-03-01,-15,3558327,3
Ecuador,201503,5,250168,50033.6,245800,0,0,0,0,-1,5,0,5,4.485363287760024e-5,2,0,0.16762052602835542,2015-03-01,5,250168,3
Greece,201503,12,3162134,263511.166666667,1057251,5,183313,36662.6,175604,-0.8904104593496773,17,47,36,0.026842364778304744,1,0.12282554718363627,2.118730470932124,2015-03-01,7,3345447,3
Honduras,201503,5,106187,21237.4,74137,0,0,0,0,-1,5,0,3,5.941395819707665e-5,3,0,0.07114867128239015,2015-03-01,5,106187,3
Israel,201503,6,89158,14859.6666666667,68659,0,0,0,0,-1,6,0,10,0.0017312551226651824,1,0,0.05973869903279441,2015-03-01,6,89158,3
Italy,201503,22,1285044,58411.0909090909,631476,6,2329729,388288.166666667,2102490,0.2890043164536196,28,303,100,0.05479977940527768,1,1.5609926148968472,0.8610203992900051,2015-03-01,16,3614773,3
Jordan,201503,9,416043,46227,140794,0,0,0,0,-1,9,0,13,0.0025717221039252497,1,0,0.2787620579387255,2015-03-01,9,416043,3
Luxembourg,201503,2,326,163,300,9,179518,19946.4444444444,107031,0.9963746357954671,11,467,25,0.0014993830128076252,1,0.1202827763405324,2.184303807251282e-4,2015-03-01,-7,179844,3
Morocco,201503,12,1801237,150103.083333333,1133687,1,19,19,19,-0.9999789036094814,13,726,29,0.027243691354782548,2,1.2730605011587226e-5,1.2068861462766496,2015-03-01,11,1801256,3
Poland,201503,11,424462,38587.4545454545,203385,9,6777092,753010.222222222,3688673,0.882119331466514,20,54,64,0.1301300117307755,1,4.540867441009879,0.28440305602254407,2015-03-01,2,7201554,3
Serbia,201503,1,130,130,130,6,561826,93637.6666666667,234761,0.9995373303247941,7,44,8,0.00382570525004484,2,0.37644131006526343,8.710413955296522e-5,2015-03-01,-5,561956,3
India,201503,9,224250,24916.6666666667,165211,0,0,0,0,-1,9,0,6,2.5955924519942015e-6,4,0,0.15025464072886502,2015-03-01,9,224250,3
Sweden,201503,2,10326,5163,7355,6,3764751,627458.5,3261972,0.9945293831092716,8,46,12,0.0769423022589479,1,2.52250304989358,0.0069187488078762995,2015-03-01,-4,3775077,3
Thailand,201503,5,367532,73506.4,302830,0,0,0,0,-1,5,0,4,2.8573905629779853e-5,4,0,0.24625814321677245,2015-03-01,5,367532,3
Egypt,201503,7,55209,7887,28358,0,0,0,0,-1,7,0,7,6.687798711545363e-4,1,0,0.0369917880044589,2015-03-01,7,55209,3
United Kingdom,201503,9,300097,33344.1111111111,187301,13,18006652,1385127.07692308,10487382,0.9672146048432739,22,142,62,0.3470452173590834,1,12.06503022068985,0.2010745459032785,2015-03-01,-4,18306749,3
United States of America,201503,9,544348,60483.1111111111,514248,0,0,0,0,-1,9,0,1,1.9073887572550123e-4,3,0,0.36473049351828857,2015-03-01,9,544348,3
Ireland,201503,1,10180,10180,10180,9,903737,100415.222222222,395735,0.9777222658075077,10,0,26,0.01830387684455772,1,0.6055325674398319,0.0068209241588398925,2015-03-01,-8,913917,3
Dominican Rep.,201503,4,27589,6897.25,27142,0,0,0,0,-1,4,0,3,2.643435359530679e-6,5,0,0.018485508508667366,2015-03-01,4,27589,3
Slovenia,201503,4,38366,9591.5,16680,12,329009,27417.4166666667,169606,0.7911343994555972,16,128,41,0.004366090869193066,1,0.22044650653985798,0.025706441677608185,2015-03-01,-8,367375,3
Guatemala,201503,3,22315,7438.33333333333,16853,1,1310,1310,1310,-0.8891005291005291,4,2,3,2.988192380638821e-9,3,8.777417139568034e-4,0.01495176057018784,2015-03-01,2,23625,3
Albania,201503,6,146778,24463,65902,0,0,0,0,-1,6,0,1,7.903768842640676e-6,2,0,0.09834593381003946,2015-03-01,6,146778,3
Croatia,201503,1,869,869,869,7,339520,48502.8571428571,179517,0.9948940770706456,8,15,15,0.005329827163386493,1,0.22748921123863658,5.822576713194368e-4,2015-03-01,-6,340389,3
Hungary,201503,7,12036,1719.42857142857,4953,8,1487626,185953.25,942982,0.983948383035644,15,185,50,0.031984221534721954,1,0.9967567900509189,0.00806450325891915,2015-03-01,-1,1499662,3
China,201503,7,6443286,920469.428571429,4607507,0,0,0,0,-1,7,0,5,2.5224503903280114e-4,6,0,4.317206791720516,2015-03-01,7,6443286,3
Portugal,201503,8,11680,1460,7344,3,466996,155665.333333333,466956,0.951198723144674,11,1083,24,0.010043836868397183,1,0.31290219042058887,0.007825971922912569,2015-03-01,5,478676,3
Slovakia,201503,3,21309,7103,18449,8,1183008,147876,592381,0.9646123072247589,11,0,29,0.02355273965773951,1,0.7926530301867253,0.014277708536416432,2015-03-01,-5,1204317,3
Estonia,201503,4,23688,5922,13853,6,71906,11984.3333333333,46282,0.5044040420946921,10,101,23,0.0010505999838976406,1,0.048179309682273214,0.015871714290235695,2015-03-01,-2,95594,3
Finland,201503,1,2,2,2,7,1372145,196020.714285714,629262,0.9999970848604414,8,47,20,0.025409784769652475,1,0.9193808428223345,1.3400636854302343e-6,2015-03-01,-6,1372147,3
Lithuania,201503,4,121622,30405.5,117902,8,1902189,237773.625,1139464,0.8798089347276006,12,308,27,0.031460780646438424,1,1.274527200862426,0.08149061277469798,2015-03-01,-4,2023811,3
Romania,201503,4,2193,548.25,1203,11,2258094,205281.272727273,658554,0.998059538456842,15,139,49,0.01614259583180603,1,1.5129948838439498,0.001469379831074252,2015-03-01,-7,2260287,3
Latvia,201503,2,91528,45764,87320,7,861870,123124.285714286,643607,0.8079962408144342,9,0,15,0.01485424360037732,1,0.577480344280878,0.061326674500029245,2015-03-01,-5,953398,3
Ukraine,201503,4,2521350,630337.5,1998500,0,0,0,0,-1,4,0,3,0.0015321155751160307,2,0,1.6893847866297607,2015-03-01,4,2521350,3
Swaziland,201503,1,15,15,15,0,0,0,0,-1,1,0,0,1.2764067493385117e-15,7,0,1.0050477640726757e-5,2015-03-01,1,15,3
Mexico,201503,3,1980875,660291.666666667,1978979,0,0,0,0,-1,3,0,0,3.3811926130337986e-5,3,0,1.3272493264383076,2015-03-01,3,1980875,3
Oman,201503,2,18996,9498,18223,0,0,0,0,-1,2,0,0,5.2828678327477406e-9,6,0,0.012727924884216365,2015-03-01,2,18996,3
Saudi Arabia,201503,2,258314,129157,190839,0,0,0,0,-1,2,0,0,1.0088173001639456e-7,6,0,0.17307860541911277,2015-03-01,2,258314,3
Dominica,201503,2,472,236,365,0,0,0,0,-1,2,0,0,2.7796695162254098e-14,3,0,3.162550297615353e-4,2015-03-01,2,472,3
Guyana,201503,1,761,761,761,0,0,0,0,-1,1,0,0,3.671650977995481e-14,3,0,5.098942323062041e-4,2015-03-01,1,761,3
Bosnia Herzegovina,201503,1,202600,202600,202600,5,137358,27471.6,65731,-0.19191194206343137,6,0,5,0.0014767454488792279,2,0.09203423385166307,0.13574845133408273,2015-03-01,-4,339958,3
Russian Federation,201503,2,1430,715,1330,11,16719459,1519950.81818182,6212020,0.9998289564627814,13,62,13,0.002229118833223035,2,11.20256992296985,9.581455350826175e-4,2015-03-01,-9,16720889,3
TFYR of Macedonia,201503,3,159527,53175.6666666667,105100,3,115332,38444,66702,-0.16079153311334174,6,96,5,7.745252853381963e-5,2,0.07727611248401989,0.1068881697728145,2015-03-01,0,274859,3
Norway,201503,1,23473,23473,23473,6,1068781,178130.166666667,717754,0.957019154885219,7,0,9,0.020523239266281815,5,0.7161173028889056,0.015727657444051944,2015-03-01,-5,1092254,3
Cyprus,201503,2,5260,2630,3045,2,42807,21403.5,27394,0.7811388270539039,4,0,1,2.201961276447464e-5,1,0.02868205309110602,0.0035243674926815163,2015-03-01,0,48067,3
Lebanon,201503,3,1653,551,701,0,0,0,0,-1,3,0,1,2.3388218708634763e-6,7,0,0.0011075626360080887,2015-03-01,3,1653,3
Saint-Barthélemy,201503,1,1841,1841,1841,0,0,0,0,-1,1,0,0,6.136862743940087e-6,1,0,0.0012335286224385306,2015-03-01,1,1841,3
Suriname,201503,1,878,878,878,0,0,0,0,-1,1,0,0,1.3563509261067358e-5,1,0,5.882879579038728e-4,2015-03-01,1,878,3
Tunisia,201503,1,1420,1420,1420,0,0,0,0,-1,1,0,0,4.337753236158713e-6,1,0,9.514452166554663e-4,2015-03-01,1,1420,3
Australia,201503,4,13831,3457.75,8340,0,0,0,0,-1,4,0,2,4.67086779856963e-9,4,0,0.009267210416592786,2015-03-01,4,13831,3
Malaysia,201503,3,688985,229661.666666667,687686,8,336885,42110.625,302830,-0.3432208759394465,11,63,11,2.8124799710782706e-6,6,0.22572367733308224,0.46164188915307497,2015-03-01,-5,1025870,3
Viet Nam,201503,1,14619,14619,14619,0,0,0,0,-1,1,0,0,2.1211615631641975e-9,4,0,0.009795195508652297,2015-03-01,1,14619,3
New Zealand,201503,1,522,522,522,0,0,0,0,-1,1,0,0,7.574022588792512e-11,4,0,3.4975662189729115e-4,2015-03-01,1,522,3
Rep. of Korea,201503,2,8804,4402,5049,0,0,0,0,-1,2,0,1,7.332080263428453e-10,4,0,0.005898960343263891,2015-03-01,2,8804,3
Japan,201503,2,27976,13988,23343,1,3755,3755,3755,-0.7633229334089692,3,1,1,7.002241393320699e-9,4,0.0025159695693952647,0.018744810831798117,2015-03-01,1,31731,3
Brazil,201503,1,32869,32869,32869,0,0,0,0,-1,1,0,0,4.099807546055176e-18,8,0,0.022023276638203186,2015-03-01,1,32869,3
"China, Hong Kong SAR",201503,1,1083,1083,1083,10,255631,25563.1,208371,0.9915625949500222,11,16,5,6.180975927025332e-6,4,0.17128090998510812,7.256444856604719e-4,2015-03-01,-9,256714,3
Indonesia,201503,1,4,4,4,0,0,0,0,-1,1,0,0,3.1212600145526656e-12,4,0,2.6801273708604685e-6,2015-03-01,1,4,3
Belarus,201503,1,2645318,2645318,2645318,10,3224e3,322400,1998500,0.09859441931754251,11,2,12,0.005323348248096747,2,2.1601826609135375,1.7724472941074683,2015-03-01,-9,5869318,3
Kyrgyzstan,201503,2,1879,939.5,1170,2,211504,105752,209792,0.9823884751831214,4,5,5,1.31828675765987e-6,2,0.14171441486161815,0.0012589898324617051,2015-03-01,0,213383,3
Uzbekistan,201503,2,842019,421009.5,841552,0,0,0,0,-1,2,0,1,5.299273685761072e-7,2,0,0.5641795421711402,2015-03-01,2,842019,3
Belize,201503,1,365844,365844,365844,0,0,0,0,-1,1,0,0,1.9143801702725293e-5,2,0,0.24512712946626933,2015-03-01,1,365844,3
Kazakhstan,201503,1,52999,52999,52999,8,2224177,278022.125,1330653,0.95345199492705,9,2,7,2.558779363465518e-5,2,1.4902694138345811,0.035511017632058495,2015-03-01,-7,2277176,3
South Africa,201503,3,71037,23679,56603,1,15,15,15,-0.999577774024658,4,3,0,3.6323663050373968e-9,7,1.0050477640726757e-5,0.04759705201095378,2015-03-01,2,71052,3
Bangladesh,201503,1,5928,5928,5928,0,0,0,0,-1,1,0,0,4.548071288140089e-9,6,0,0.003971948763615215,2015-03-01,1,5928,3
Pakistan,201503,1,539,539,539,0,0,0,0,-1,1,0,0,4.135307765930443e-10,6,0,3.6114716322344813e-4,2015-03-01,1,539,3
Kenya,201503,1,30,30,30,0,0,0,0,-1,1,0,0,0,9,0,2.0100955281453514e-5,2015-03-01,1,30,3
Canada,201503,1,26186,26186,26186,16,2690417,168151.0625,1978979,0.9807215113875675,17,0,5,7.278295631043414e-4,5,1.8026650601820773,0.017545453833338057,2015-03-01,-15,2716603,3
United Arab Emirates,201503,1,6801,6801,6801,0,0,0,0,-1,1,0,0,2.3730717679708317e-8,7,0,0.004556886562305512,2015-03-01,1,6801,3
Argentina,201503,1,23,23,23,0,0,0,0,-1,1,0,0,3.92967432014806e-10,5,0,1.5410732382447694e-5,2015-03-01,1,23,3
Turkmenistan,201503,1,5605,5605,5605,0,0,0,0,-1,1,0,0,3.3667237753128344e-9,2,0,0.003755528478418232,2015-03-01,1,5605,3
Chile,201503,1,129,129,129,0,0,0,0,-1,1,0,0,2.2040347230499128e-9,5,0,8.643410771025011e-5,2015-03-01,1,129,3
United Rep. of Tanzania,201503,1,45050,45050,45050,0,0,0,0,-1,1,0,0,7.697035973424503e-7,5,0,0.030184934514316027,2015-03-01,1,45050,3
Georgia,201503,0,0,0,0,3,729072,243024,607552,1,3,0,2,8.843715611565944e-5,2,0.4885014556319959,0,2015-03-01,-3,729072,3
El Salvador,201503,0,0,0,0,2,79532,39766,74137,1,2,0,1,1.0340085099600555e-7,3,0.0532889725148187,0,2015-03-01,-2,79532,3
Iceland,201503,0,0,0,0,2,691,345.5,658,1,2,0,1,1.0873169828844305e-5,1,4.6299200331614593e-4,0,2015-03-01,-2,691,3
Montenegro,201503,0,0,0,0,6,72884,12147.3333333333,41932,1,6,0,3,8.134524814705296e-5,1,0.0488346008244486,0,2015-03-01,-6,72884,3
Switzerland,201503,0,0,0,0,17,3523406,207259.176470588,3022958,1,17,0,40,0.06995518270319624,6,2.3607942148135,0,2015-03-01,-17,3523406,3
Azerbaijan,201503,0,0,0,0,1,858530,858530,858530,1,1,0,0,7.212690793316811e-6,2,0.5752424379262095,0,2015-03-01,-1,858530,3
Nicaragua,201503,0,0,0,0,3,23588,7862.66666666667,16853,1,3,0,1,8.292400471494778e-9,3,0.015804711105964184,0,2015-03-01,-3,23588,3
Qatar,201503,0,0,0,0,9,248480,27608.8888888889,190839,1,9,0,8,1.0963170071564477e-5,1,0.1664895122778523,0,2015-03-01,-9,248480,3
Antigua and Barbuda,201503,0,0,0,0,3,2629,876.333333333333,2460,1,3,0,0,1.1063928114317556e-8,3,0.001761513714498043,0,2015-03-01,-3,2629,3
Barbados,201503,0,0,0,0,2,1220,610,761,1,2,0,0,2.0551850603790606e-9,3,8.174388481124429e-4,0,2015-03-01,-2,1220,3
Bolivia,201503,0,0,0,0,1,106,106,106,1,1,0,0,4.746179021962539e-10,3,7.102337532780242e-5,0,2015-03-01,-1,106,3
Malta,201503,0,0,0,0,2,25491,12745.5,19021,1,2,0,1,1.2441849407640202e-4,1,0.01707978170265105,0,2015-03-01,-2,25491,3
Rep. of Moldova,201503,0,0,0,0,2,188809,94404.5,188534,1,2,0,1,2.746526733014023e-5,1,0.12650804219119854,0,2015-03-01,-2,188809,3
Paraguay,201503,0,0,0,0,1,32869,32869,32869,1,1,0,0,4.099807546055176e-18,8,0.022023276638203186,0,2015-03-01,-1,32869,3
Singapore,201503,0,0,0,0,9,792754,88083.7777777778,687686,1,9,0,8,3.324072578300469e-5,4,0.5311704234397799,0,2015-03-01,-9,792754,3
Montserrat,201503,0,0,0,0,1,365,365,365,1,1,0,0,5.466410061406902e-18,3,2.4456162259101777e-4,0,2015-03-01,-1,365,3
Cabo Verde,201503,0,0,0,0,2,1131,565.5,866,1,2,0,1,1.8648991787367326e-5,1,7.578060141107975e-4,0,2015-03-01,-2,1131,3
Mozambique,201503,0,0,0,0,1,13393,13393,13393,1,1,0,0,1.142006858363731e-12,7,0.008973736469483564,0,2015-03-01,-1,13393,3
Bermuda,201503,0,0,0,0,1,17604,17604,17604,1,1,0,0,7.882239151525393e-8,3,0.011795240559156922,0,2015-03-01,-1,17604,3
Greenland,201503,0,0,0,0,3,19108,6369.33333333333,11659,1,3,0,3,2.3310925608525887e-5,1,0.01280296845060046,0,2015-03-01,-3,19108,3
Kuwait,201503,0,0,0,0,9,264199,29355.4444444444,165211,1,9,0,2,3.268285891259972e-5,6,0.17702174281349123,0,2015-03-01,-9,264199,3
Uganda,201503,0,0,0,0,1,30,30,30,1,1,0,0,-0,9,2.0100955281453514e-5,0,2015-03-01,-1,30,3
Saint Vincent and the Grenadines,201503,0,0,0,0,1,222,222,222,1,1,0,0,9.940110762765207e-10,3,1.48747069082756e-4,0,2015-03-01,-1,222,3
Botswana,201503,0,0,0,0,1,56603,56603,56603,1,1,0,0,4.826457435517996e-12,7,0.03792581239320378,0,2015-03-01,-1,56603,3
Seychelles,201503,0,0,0,0,8,21547,2693.375,8744,1,8,0,5,1.4864115409916605e-4,7,0.014437176114982629,0,2015-03-01,-8,21547,3
Greece,201504,13,2343771,180290.076923077,807395,7,10405,1486.42857142857,4171,-0.9911603890278382,20,354,56,0.02276679101504104,1,0.008504978833484162,1.9157830605991357,2015-04-01,6,2354176,4
Iran,201504,5,1964903,392980.6,1226068,0,0,0,0,-1,5,0,1,8.40107907199309e-5,2,0,1.606098839485779,2015-04-01,5,1964903,4
Albania,201504,9,1267832,140870.222222222,493152,0,0,0,0,-1,9,0,14,2.4151202343569852e-4,1,0,1.0363175708230554,2015-04-01,9,1267832,4
Austria,201504,8,235944,29493,157412,11,1657637,150694.272727273,487469,0.7507959786246271,19,100,56,0.03165344772870486,1,1.3549416240845926,0.19285907985464557,2015-04-01,-3,1893581,4
Bulgaria,201504,7,808979,115568.428571429,733997,6,734577,122429.5,209123,-0.04820168494048807,13,0,22,0.021519675054011176,1,0.600438427348803,0.661254134717269,2015-04-01,1,1543556,4
Germany,201504,26,4203396,161669.076923077,844703,23,50875857,2211993.7826087,29126190,0.8473691718368076,49,1406,163,1,1,41.585592207627776,3.435828352595098,2015-04-01,3,55079253,4
Italy,201504,22,1193453,54247.8636363636,209529,8,1418920,177365,1169734,0.08630735350579721,30,1024,95,0.028083816549731817,1,1.1598159121967657,0.975520663503909,2015-04-01,14,2612373,4
Poland,201504,14,834029,59573.5,357890,8,1768958,221119.75,698618,0.3591754396007356,22,151,77,0.03892338690230119,1,1.4459346801847646,0.6817298406066278,2015-04-01,6,2602987,4
Turkey,201504,21,3403655,162078.80952381,1220995,0,0,0,0,-1,21,0,47,0.004558378191214866,1,0,2.782125298556707,2015-04-01,21,3403655,4
Rep. of Korea,201504,3,6447,2149,4524,0,0,0,0,-1,3,0,2,8.847178987963817e-10,2,0,0.005269735563620604,2015-04-01,3,6447,4
Indonesia,201504,2,85,42.5,63,0,0,0,0,-1,2,0,0,3.783384317753752e-9,2,0,6.947844313754481e-5,2015-04-01,2,85,4
Morocco,201504,9,526791,58532.3333333333,252908,0,0,0,0,-1,9,0,20,0.004623850551356373,1,0,0.4305955122220043,2015-04-01,9,526791,4
Netherlands,201504,36,55106245,1530729.02777778,29126190,8,3133756,391719.5,1753991,-0.892384754595042,44,520,137,0.955810267051234,1,2.5615116241522338,45.043483644189564,2015-04-01,28,58240001,4
Portugal,201504,7,8201,1171.57142857143,4023,3,213265,71088.3333333333,213141,0.9259389703159853,10,578,18,0.0029661537993531284,1,0.17432141383209993,0.006703443672600059,2015-04-01,4,221466,4
Spain,201504,33,36144937,1095301.12121212,17236303,11,432950,39359.0909090909,252908,-0.9763272274311526,44,202,157,0.5310315470019509,1,0.3538904936047062,29.544634706642817,2015-04-01,22,36577887,4
Egypt,201504,5,13301,2660.2,12234,0,0,0,0,-1,5,0,6,3.240407559624897e-4,1,0,0.010872150260852748,2015-04-01,5,13301,4
Belgium,201504,10,4563065,456306.5,2206857,10,8797686,879768.6,7693742,0.316944833415427,20,144,54,0.3046892389882003,1,7.191170899917342,3.729819436887305,2015-04-01,0,13360751,4
France,201504,20,2016563,100828.15,905023,16,6967032,435439.5,4069513,0.5510565647716755,36,540,109,0.10486648132384771,1,5.694806313523001,1.6483253850444326,2015-04-01,4,8983595,4
Guyana,201504,1,1230,1230,1230,0,0,0,0,-1,1,0,0,2.672403067240244e-16,3,0,0.0010053939418727073,2015-04-01,1,1230,4
United States of America,201504,9,641338,71259.7777777778,622620,0,0,0,0,-1,9,0,2,5.981913810051149e-7,3,0,0.5242254795876085,2015-04-01,9,641338,4
Guatemala,201504,2,14880,7440,14413,0,0,0,0,-1,2,0,0,4.4554776331510935e-10,4,0,0.012162814516313727,2015-04-01,2,14880,4
Honduras,201504,3,27166,9055.33333333333,21671,0,0,0,0,-1,3,0,0,1.494629028544611e-6,4,0,0.02220531042675932,2015-04-01,3,27166,4
Armenia,201504,2,379955,189977.5,364021,1,8677,8677,8677,-0.9553459313695218,3,0,2,2.601302110046866e-5,2,0.00709252295417031,0.3105727277920687,2015-04-01,1,388632,4
Sweden,201504,2,23726,11863,20217,9,2418608,268734.222222222,1834411,0.9805710439276528,11,51,27,0.05322180292872121,1,1.9769543341177762,0.01939347696331045,2015-04-01,-7,2442334,4
Pakistan,201504,2,1364,682,1288,0,0,0,0,-1,2,0,0,8.513195398439085e-8,3,0,0.001114924663995425,2015-04-01,2,1364,4
India,201504,7,192209,27458.4285714286,142070,0,0,0,0,-1,7,0,0,8.670882449571373e-7,4,0,0.15711037737675707,2015-04-01,7,192209,4
Dominican Rep.,201504,4,5561,1390.25,3731,0,0,0,0,-1,4,0,1,1.0957120851394047e-5,1,0,0.004545524968092784,2015-04-01,4,5561,4
Romania,201504,6,645449,107574.833333333,462540,10,1410814,141081.4,392161,0.3722116285708589,16,2,67,0.010806883118402532,1,1.1531901209017899,0.5275857840551196,2015-04-01,-4,2056263,4
Slovakia,201504,3,13612,4537.33333333333,10455,12,1049573,87464.4166666667,517625,0.9743939201550059,15,78,49,0.018118576554615313,1,0.8579140941082626,0.011126359623391294,2015-04-01,-9,1063185,4
TFYR of Macedonia,201504,8,510030,63753.75,371174,2,374594,187297,366556,-0.15310007415579951,10,105,15,7.577475099835752e-5,1,0.3061906815137113,0.41689518062872916,2015-04-01,6,884624,4
United Kingdom,201504,8,136579,17072.375,43089,12,14550304,1212525.33333333,10482264,0.9814012272038934,20,279,47,0.32536491560243297,1,11.893323165858716,0.11163877982685567,2015-04-01,-4,14686883,4
Ukraine,201504,5,968411,193682.2,907100,0,0,0,0,-1,5,0,6,3.3737876484106816e-5,1,0,0.79157280702674,2015-04-01,5,968411,4
Finland,201504,2,15045,7522.5,15037,7,506406,72343.7142857143,267367,0.9422956327631935,9,136,12,0.009369957476396507,1,0.41393294677072373,0.012297684435345431,2015-04-01,-5,521451,4
Latvia,201504,2,51118,25559,44641,7,325217,46459.5714285714,115772,0.7283377841550746,9,0,16,0.003398319447085465,1,0.26583024519838716,0.041783518309470774,2015-04-01,-5,376335,4
Lithuania,201504,4,114156,28539,86160,8,920502,115062.75,357890,0.7793357805187802,12,0,30,0.008746697124001794,1,0.7524123042940738,0.09331036652717135,2015-04-01,-4,1034658,4
Czech Rep.,201504,4,46176,11544,24531,15,4982920,332194.666666667,1934468,0.9816364611055347,19,36,69,0.07174136648793526,1,4.073006163281586,0.03774395988610905,2015-04-01,-11,5029096,4
Estonia,201504,5,75738,15147.6,63057,9,115124,12791.5555555556,29103,0.20635852081608702,14,224,34,7.591259291186655e-4,1,0.09410160338549069,0.061907745015898456,2015-04-01,-4,190862,4
Hungary,201504,6,43974,7329,21913,7,1102542,157506,562322,0.9232910835958679,13,160,38,0.02034976374359655,1,0.9012106076912345,0.0359440595121223,2015-04-01,-1,1146516,4
Jordan,201504,6,107893,17982.1666666667,48996,0,0,0,0,-1,6,0,9,7.785558544390376e-4,1,0,0.08819103135810732,2015-04-01,6,107893,4
Luxembourg,201504,2,21085,10542.5,21058,10,189218,18921.8,121342,0.7994797981959363,12,350,30,0.002286111044037838,1,0.15466555357176417,0.017234740865354498,2015-04-01,-8,210303,4
Colombia,201504,3,3817,1272.33333333333,2403,0,0,0,0,-1,3,0,1,4.1730477404151606e-5,1,0,0.0031199907936001006,2015-04-01,3,3817,4
Lebanon,201504,4,12120,3030,6863,0,0,0,0,-1,4,0,2,5.991221015038955e-5,5,0,0.009906808597965213,2015-04-01,4,12120,4
Mauritius,201504,1,51,51,51,0,0,0,0,-1,1,0,0,1.3975141506727492e-7,1,0,4.168706588252689e-5,2015-04-01,1,51,4
Saint-Barthélemy,201504,1,1851,1851,1851,0,0,0,0,-1,1,0,0,5.072154300069329e-6,1,0,0.0015129952735011228,2015-04-01,1,1851,4
Denmark,201504,5,34744,6948.8,20918,22,1452256,66011.6363636364,681433,0.9532696704774715,27,1470,122,0.027569865992785287,1,1.187064540201862,0.02839951798083361,2015-04-01,-17,1487e3,4
Israel,201504,3,57514,19171.3333333333,54841,0,0,0,0,-1,3,0,3,0.0014463118851882602,1,0,0.04701156680720885,2015-04-01,3,57514,4
Brazil,201504,2,19546,9773,15408,0,0,0,0,-1,2,0,0,1.0812843038876191e-4,1,0,0.0159767723478406,2015-04-01,2,19546,4
Costa Rica,201504,2,352,176,247,0,0,0,0,-1,2,0,0,6.454357711719892e-6,1,0,2.877224939343032e-4,2015-04-01,2,352,4
Peru,201504,1,461,461,461,0,0,0,0,-1,1,0,0,1.2046205492704375e-5,1,0,3.7681837984009596e-4,2015-04-01,1,461,4
Thailand,201504,4,383262,95815.5,314132,0,0,0,0,-1,4,0,2,1.4855044087759555e-5,2,0,0.31327584792684354,2015-04-01,4,383262,4
Croatia,201504,3,31108,10369.3333333333,27418,8,590485,73810.625,290001,0.8999087827565626,11,157,23,0.006167268405860053,1,0.48265857054203704,0.025427475401444046,2015-04-01,-5,621593,4
Fiji,201504,1,711,711,711,0,0,0,0,-1,1,0,0,5.961793955782591e-8,1,0,5.811667420093454e-4,2015-04-01,1,711,4
Ireland,201504,1,12412,12412,12412,10,485304,48530.4,210631,0.9501241671957502,11,0,27,0.008600575211723291,1,0.3966843102167417,0.010145487484978897,2015-04-01,-9,497716,4
Japan,201504,3,25473,8491,21430,1,1815,1815,1815,-0.8669744942832014,4,2,4,7.2833807840489845e-9,2,0.0014835691093487509,0.020821463318149165,2015-04-01,2,27288,4
Russian Federation,201504,2,15117,7558.5,13400,10,12218135,1221813.5,5466410,0.9975285394268016,12,11,7,0.002620801618258153,2,9.98702350405113,0.012356536763650176,2015-04-01,-8,12233252,4
China,201504,5,6175849,1235169.8,5466410,0,0,0,0,-1,5,0,3,3.745689515302603e-4,2,0,5.048098512618388,2015-04-01,5,6175849,4
New Zealand,201504,1,186,186,186,0,0,0,0,-1,1,0,0,3.233859295164601e-11,2,0,1.520351814539216e-4,2015-04-01,1,186,4
Viet Nam,201504,2,9009,4504.5,7316,0,0,0,0,-1,2,0,1,1.5711072694940864e-9,2,0,0.007363897579131073,2015-04-01,2,9009,4
Malaysia,201504,2,773807,386903.5,773357,12,335596,27966.3333333333,314132,-0.3949971290865447,14,23,15,6.761489814006102e-6,2,0.27431397180220574,0.6325047723404016,2015-04-01,-10,1109403,4
Australia,201504,4,17329,4332.25,10291,0,0,0,0,-1,4,0,2,6.548870153162715e-9,2,0,0.014164611072123695,2015-04-01,4,17329,4
Cyprus,201504,1,11684,11684,11684,1,21541,21541,21541,0.29667419112114374,2,0,1,2.2479064212859618e-5,1,0.01760747227795121,0.009550425054342043,2015-04-01,0,33225,4
Norway,201504,1,27235,27235,27235,4,554451,138612.75,392436,0.906358413302022,5,0,6,0.011884572652065134,1,0.4532046150124101,0.022261710574718034,2015-04-01,-3,581686,4
Panama,201504,1,30800,30800,30800,0,0,0,0,-1,1,0,0,7.541151720454577e-6,1,0,0.025175718219251533,2015-04-01,1,30800,4
Slovenia,201504,4,15649,3912.25,10186,10,502257,50225.7,209529,0.9395681841878643,14,902,21,0.0032089135693019995,1,0.4105415813521629,0.012791390078346338,2015-04-01,-6,517906,4
Uzbekistan,201504,2,1869766,934883,1867437,0,0,0,0,-1,2,0,1,7.180495156347981e-7,2,0,1.5283344789589954,2015-04-01,2,1869766,4
Ecuador,201504,2,460,230,248,0,0,0,0,-1,2,0,1,3.4414926900830384e-6,1,0,3.76000986391419e-4,2015-04-01,2,460,4
Uganda,201504,1,671,671,671,1,7,7,7,-0.9793510324483776,2,47,0,5.342308682768889e-6,3,5.721754140738985e-6,5.484710040622655e-4,2015-04-01,0,678,4
Dominica,201504,2,482,241,351,0,0,0,0,-1,2,0,1,4.319035260186253e-17,3,0,3.939836422623129e-4,2015-04-01,2,482,4
Cameroon,201504,1,9,9,9,0,0,0,0,-1,1,0,0,7.165540705692917e-8,1,0,7.35654103809298e-6,2015-04-01,1,9,4
Bangladesh,201504,2,8378,4189,8031,0,0,0,0,-1,2,0,0,9.28228026830235e-9,3,0,0.006848122313015887,2015-04-01,2,8378,4
"China, Hong Kong SAR",201504,1,2113,2113,2113,10,198529,19852.9,156620,0.97893761027103,11,3,8,6.653634951221582e-6,2,0.1622763039723957,0.0017271523570544962,2015-04-01,-9,200642,4
Antigua and Barbuda,201504,1,101,101,101,2,1176,588,1045,0.8418167580266249,3,2,1,1.633447797934883e-11,3,9.612546956441494e-4,8.255673831637677e-5,2015-04-01,-1,1277,4
Saint Kitts and Nevis,201504,1,55,55,55,0,0,0,0,-1,1,0,0,0,3,0,4.4956639677234875e-5,2015-04-01,1,55,4
Belize,201504,1,43694,43694,43694,0,0,0,0,-1,1,0,0,2.9923011163099623e-6,2,0,0.03571518934649274,2015-04-01,1,43694,4
Belarus,201504,1,3548612,3548612,3548612,8,1049600,131200,907100,-0.5434747245233582,9,0,12,6.831817805879862e-4,1,0.8579361637313768,2.9006122006965787,2015-04-01,-7,4598212,4
Kazakhstan,201504,1,107516,107516,107516,7,2414243,344891.857142857,1867437,0.9147293615289962,8,10,4,1.4714066382032748e-5,2,1.9733864117143012,0.0878828740279561,2015-04-01,-6,2521759,4
South Africa,201504,2,44324,22162,35826,0,0,0,0,-1,2,0,0,5.398794075232816e-18,6,0,0.03623014721915925,2015-04-01,2,44324,4
Sri Lanka,201504,1,2729,2729,2729,0,0,0,0,-1,1,0,0,3.1333621876315574e-9,3,0,0.002230666721439527,2015-04-01,1,2729,4
Kenya,201504,2,1249,624.5,1242,0,0,0,0,-1,2,0,0,1.4270071606322309e-9,3,0,0.0010209244173975702,2015-04-01,2,1249,4
Saudi Arabia,201504,1,7022,7022,7022,0,0,0,0,-1,1,0,0,8.062465850975392e-9,3,0,0.005739736796609878,2015-04-01,1,7022,4
Mexico,201504,1,1286938,1286938,1286938,0,0,0,0,-1,1,0,0,1.2269422893379905e-6,4,0,1.051934690053478,2015-04-01,1,1286938,4
Argentina,201504,1,20,20,20,0,0,0,0,-1,1,0,0,1.9067612081141367e-11,4,0,1.6347868973539956e-5,2015-04-01,1,20,4
Canada,201504,1,36993,36993,36993,14,1960795,140056.785714286,1286938,0.9629660404407274,15,0,3,3.648523677255503e-5,4,1.6027409871986138,0.03023783584690818,2015-04-01,-13,1997788,4
Turkmenistan,201504,1,48174,48174,48174,0,0,0,0,-1,1,0,0,1.8522293480366787e-8,2,0,0.03937711199656569,2015-04-01,1,48174,4
United Arab Emirates,201504,1,2539,2539,2539,0,0,0,0,-1,1,0,0,1.1575138326739464e-8,5,0,0.002075361966190897,2015-04-01,1,2539,4
Kyrgyzstan,201504,1,490,490,490,2,75529,37764.5,73200,0.9871084860363857,3,6,2,7.166925098698043e-7,2,0.061736909785124965,4.005227898517289e-4,2015-04-01,-1,76019,4
Azerbaijan,201504,0,0,0,0,1,714890,714890,714890,1,1,0,0,1.5693638210914079e-6,2,0.5843464025246989,0,2015-04-01,-1,714890,4
Barbados,201504,0,0,0,0,2,1768,884,1230,1,2,0,0,8.409523370785675e-12,3,0.001445151617260932,0,2015-04-01,-2,1768,4
El Salvador,201504,0,0,0,0,2,36084,18042,21671,1,2,0,0,8.465406126294588e-10,4,0.029494825202060787,0,2015-04-01,-2,36084,4
Georgia,201504,0,0,0,0,4,891410,222852.5,872122,1,4,0,1,1.2053187210064147e-4,2,0.7286326940851626,0,2015-04-01,-4,891410,4
Montenegro,201504,0,0,0,0,3,123010,41003.3333333333,82151,1,3,0,1,4.254106326974957e-5,1,0.1005475681217575,0,2015-04-01,-3,123010,4
Switzerland,201504,0,0,0,0,13,2636383,202798.692307692,1889409,1,13,0,27,0.0421229857571625,1,2.1549621924034095,0,2015-04-01,-13,2636383,4
Iceland,201504,0,0,0,0,2,641,320.5,540,1,2,0,1,1.4345682420830408e-5,1,5.239492006019556e-4,0,2015-04-01,-2,641,4
Paraguay,201504,0,0,0,0,1,15408,15408,15408,1,1,0,0,4.3534695437949774e-8,1,0.012594398257215181,0,2015-04-01,-1,15408,4
Malta,201504,0,0,0,0,2,15306,7653,12029,1,2,0,1,9.06734473677084e-5,1,0.012511024125450129,0,2015-04-01,-2,15306,4
Cabo Verde,201504,0,0,0,0,1,1212,1212,1212,1,1,0,0,1.6817920059898828e-5,1,9.906808597965214e-4,0,2015-04-01,-1,1212,4
Montserrat,201504,0,0,0,0,3,507,169,351,1,3,0,1,2.6993970376164082e-17,3,4.144184784792379e-4,0,2015-04-01,-3,507,4
Serbia,201504,0,0,0,0,9,1240751,137861.222222222,493152,1,9,0,17,0.0018863549861624909,1,1.0141817388394336,0,2015-04-01,-9,1240751,4
Singapore,201504,0,0,0,0,10,881630,88163,773357,1,10,0,8,3.46600200421133e-5,2,0.7206385861571015,0,2015-04-01,-10,881630,4
Bosnia Herzegovina,201504,0,0,0,0,5,340217,68043.4,125105,1,5,0,2,0.0018137574493000078,1,0.27809114692854214,0,2015-04-01,-5,340217,4
Mozambique,201504,0,0,0,0,1,8498,8498,8498,1,1,0,0,0,6,0.0069462095268571274,0,2015-04-01,-1,8498,4
Bermuda,201504,0,0,0,0,1,9589,9589,9589,1,1,0,0,1.4988659573842495e-10,3,0.007837985779363732,0,2015-04-01,-1,9589,4
Greenland,201504,0,0,0,0,3,14984,4994.66666666667,10726,1,3,0,3,1.1299906033245403e-5,1,0.012247823434976135,0,2015-04-01,-3,14984,4
Kuwait,201504,0,0,0,0,10,182130,18213,142070,1,10,0,0,4.393976412337153e-5,3,0.1488718688075416,0,2015-04-01,-10,182130,4
Rep. of Moldova,201504,0,0,0,0,4,345791,86447.75,219059,1,4,0,4,6.0169885681754593e-5,1,0.28264729801146776,0,2015-04-01,-4,345791,4
Algeria,201504,0,0,0,0,1,15246,15246,15246,1,1,0,0,3.454367559391499e-10,4,0.012461980518529508,0,2015-04-01,-1,15246,4
Saint Vincent and the Grenadines,201504,0,0,0,0,1,180,180,180,1,1,0,0,2.8135923298957327e-12,3,1.471308207618596e-4,0,2015-04-01,-1,180,4
Botswana,201504,0,0,0,0,1,35826,35826,35826,1,1,0,0,-0,6,0.02928393769230212,0,2015-04-01,-1,35826,4
Seychelles,201504,0,0,0,0,6,11992,1998.66666666667,6830,1,6,0,3,1.744673429393371e-4,5,0.009802182236534557,0,2015-04-01,-6,11992,4
Austria,201505,8,803135,100391.875,663505,12,1008217,84018.0833333333,229590,0.11322040111474743,20,177,80,0.03326496466059071,1,0.9847824875414478,0.7844673152025811,2015-05-01,-4,1811352,5
Belgium,201505,10,4577709,457770.9,2229243,8,5809831,726228.875,4884285,0.11861537957976576,18,127,45,0.2778199752348869,1,5.67479007433461,4.471306927239745,2015-05-01,2,10387540,5
Bulgaria,201505,6,640229,106704.833333333,314283,5,475469,95093.8,244988,-0.14767437066302888,11,53,16,0.00992760414863157,1,0.4644174265746805,0.6253478241451728,2015-05-01,1,1115698,5
Germany,201505,21,2413990,114951.904761905,531209,24,40981919,1707579.95833333,26512429,0.8887457340736888,45,850,140,0.9543383535523869,1,40.029354927602014,2.3578803740664753,2015-05-01,-3,43395909,5
Greece,201505,10,846136,84613.6,435011,1,2901,2901,2901,-0.9931663755525377,11,4,27,0.013309450836950351,1,0.002833570547171631,0.8264688205796673,2015-05-01,9,849037,5
Hungary,201505,6,36561,6093.5,24759,7,615377,87911,279945,0.8878390276375975,13,144,54,0.011881483914921599,1,0.6010734721154212,0.03571119364879076,2015-05-01,-1,651938,5
Italy,201505,23,837336,36405.9130434783,271796,8,766609,95826.125,504758,-0.044095651658878576,31,633,100,0.01740830788483395,1,0.7487903080305746,0.8178733635596362,2015-05-01,15,1603945,5
Netherlands,201505,32,49480272,1546258.5,26512429,7,2191656,313093.714285714,1506164,-0.9151703416214699,39,378,135,1,1,2.140714198942429,48.33017628584665,2015-05-01,25,51671928,5
Poland,201505,11,915957,83268.8181818182,424908,4,535527,133881.75,289801,-0.2620972742379523,15,0,52,0.016633858859086817,1,0.523079467223434,0.8946669347382576,2015-05-01,7,1451484,5
Romania,201505,12,1791068,149255.666666667,823376,7,51379,7339.85714285714,21821,-0.9442274323223409,19,659,54,0.019076176368989776,1,0.05018477116274775,1.749437274312857,2015-05-01,5,1842447,5
Slovakia,201505,5,61413,12282.6,47568,14,938898,67064.1428571429,333984,0.8772121870098399,19,85,69,0.014908236679213696,1,0.9170747051355911,0.059985545678542355,2015-05-01,-9,1000311,5
Spain,201505,31,18796644,606343.35483871,9820009,12,207068,17255.6666666667,70959,-0.9782076259627592,43,954,148,0.3449344869169737,1,0.20225501070725102,18.359743820775716,2015-05-01,19,19003712,5
TFYR of Macedonia,201505,11,2373061,215732.818181818,1558708,1,236626,236626,236626,-0.8186556472097994,12,0,22,3.9766132454522105e-4,1,0.23112597872976018,2.3179027081150148,2015-05-01,10,2609687,5
United Kingdom,201505,7,113491,16213,85989,11,13519720,1229065.45454545,11823303,0.9833508041502476,18,342,53,0.3841749426355247,1,13.20547411168812,0.11085306962049485,2015-05-01,-4,13633211,5
Australia,201505,5,45682,9136.4,25557,0,0,0,0,-1,5,0,4,2.0016674196186028e-8,1,0,0.04462018949875713,2015-05-01,5,45682,5
France,201505,17,1358044,79884.9411764706,679656,19,6134312,322858.526315789,2493954,0.6374854585126494,36,786,98,0.1095453356908825,1,5.991728993575147,1.3264782765126337,2015-05-01,-2,7492356,5
Lebanon,201505,4,6517,1629.25,2714,0,0,0,0,-1,4,0,2,2.8503221800836982e-5,1,0,0.006365521977220792,2015-05-01,4,6517,5
Oman,201505,1,28,28,28,0,0,0,0,-1,1,0,0,2.0606323409308106e-10,1,0,2.7349181427371826e-5,2015-05-01,1,28,5
United Arab Emirates,201505,1,4866,4866,4866,0,0,0,0,-1,1,0,0,3.581084619590448e-8,1,0,0.0047528970294854036,2015-05-01,1,4866,5
Czech Rep.,201505,5,24266,4853.2,21856,14,4669424,333530.285714286,1495010,0.9896601607690325,19,253,78,0.06682483709228511,1,4.56089014776158,0.02370197273273588,2015-05-01,-9,4693690,5
Brazil,201505,2,31591,15795.5,19576,0,0,0,0,-1,2,0,0,3.5588833675473196e-4,1,0,0.03085671394543226,2015-05-01,2,31591,5
Rep. of Korea,201505,3,10689,3563,6016,0,0,0,0,-1,3,0,3,1.9081479673739685e-9,1,0,0.010440550009899194,2015-05-01,3,10689,5
United States of America,201505,10,923500,92350,882782,0,0,0,0,-1,10,0,7,1.9418090897544384e-4,1,0,0.9020346088634957,2015-05-01,10,923500,5
Colombia,201505,1,981,981,981,0,0,0,0,-1,1,0,0,2.9057538865620545e-5,1,0,9.581981064375628e-4,2015-05-01,1,981,5
Turkey,201505,16,1988237,124264.8125,1217898,0,0,0,0,-1,16,0,34,0.0022857158961749283,1,0,1.9420233726290526,2015-05-01,16,1988237,5
Thailand,201505,4,374325,93581.25,297112,0,0,0,0,-1,4,0,4,3.9016594825745334e-5,1,0,0.36562436920717706,2015-05-01,4,374325,5
Morocco,201505,4,94714,23678.5,70959,0,0,0,0,-1,4,0,4,7.724120098099416e-4,1,0,0.09251251320400339,2015-05-01,4,94714,5
Costa Rica,201505,2,971,485.5,603,0,0,0,0,-1,2,0,0,1.0905976741555888e-5,2,0,9.484305416420729e-4,2015-05-01,2,971,5
Denmark,201505,4,35545,8886.25,19771,20,1494031,74701.55,1045445,0.9535230678305622,24,482,112,0.038397885554322504,1,1.4593044598970626,0.034718809065568984,2015-05-01,-16,1529576,5
Israel,201505,2,17582,8791,17150,0,0,0,0,-1,2,0,0,5.079960953720674e-4,1,0,0.01717333242343041,2015-05-01,2,17582,5
Jordan,201505,6,60442,10073.6666666667,22684,0,0,0,0,-1,6,0,10,4.061487720579153e-4,1,0,0.05903711513690028,2015-05-01,6,60442,5
Luxembourg,201505,1,14090,14090,14090,9,160246,17805.1111111111,108417,0.8383581130690162,10,40,19,0.002088114917007259,1,0.15652131882180806,0.013762498796845322,2015-05-01,-8,174336,5
Portugal,201505,8,11423,1427.875,4906,3,77174,25724.6666666667,57633,0.7421357382304141,11,383,16,0.001250018068035928,1,0.07538020455271405,0.011157489265888155,2015-05-01,5,88597,5
Egypt,201505,5,54838,10967.6,51e3,0,0,0,0,-1,5,0,1,1.0511091139069016e-4,1,0,0.053563371825507716,2015-05-01,5,54838,5
New Zealand,201505,1,321,321,321,1,25557,25557,25557,0.9751912821701831,2,0,1,1.36579986707518e-10,1,0.024962965347833634,3.1353882993522697e-4,2015-05-01,0,25878,5
Malaysia,201505,2,888104,444052,886885,13,348351,26796.2307692308,297112,-0.43653266799034335,15,11,17,1.2441709964630812e-5,1,0.34025409640737153,0.8674613365133795,2015-05-01,-11,1236455,5
China,201505,5,4519559,903911.8,4199462,0,0,0,0,-1,5,0,4,7.320384516384303e-5,1,0,4.414508537953971,2015-05-01,5,4519559,5
Japan,201505,3,50378,16792.6666666667,43501,2,19754,9877,13738,-0.4366622939599612,5,0,8,1.101130430614273e-7,1,0.019294847497010822,0.049207037926719203,2015-05-01,1,70132,5
Indonesia,201505,4,7906,1976.5,6271,0,0,0,0,-1,4,0,1,8.421374564007443e-9,1,0,0.0077222367273143445,2015-05-01,4,7906,5
Dominican Rep.,201505,4,69258,17314.5,66676,0,0,0,0,-1,4,0,1,1.6451362189805795e-5,1,0,0.06764820026060421,2015-05-01,4,69258,5
India,201505,7,226124,32303.4285714286,173419,0,0,0,0,-1,7,0,1,9.687688579498589e-7,1,0,0.22086808218153667,2015-05-01,7,226124,5
Albania,201505,7,1041751,148821.571428571,387708,0,0,0,0,-1,7,0,9,8.013724755994377e-5,1,0,1.0175370393266439,2015-05-01,7,1041751,5
Serbia,201505,3,14014,4671.33333333333,7499,5,1984605,396921,1558708,0.9859763166466445,8,54,12,9.578531692295615e-5,1,1.9384757930953307,0.013688265304399597,2015-05-01,-2,1998619,5
Sweden,201505,1,3633,3633,3633,8,374689,46836.125,254506,0.9807941383266107,9,0,26,0.004195624593972664,1,0.3659799085657329,0.0035485562902014944,2015-05-01,-7,378322,5
Iran,201505,4,461871,115467.75,267540,0,0,0,0,-1,4,0,1,3.321833168428597e-6,1,0,0.4511354919657733,2015-05-01,4,461871,5
Dominica,201505,1,109,109,109,0,0,0,0,-1,1,0,0,2.3653409057790723e-14,1,0,1.0646645627084032e-4,2015-05-01,1,109,5
Estonia,201505,5,32161,6432.2,15617,6,50712,8452,32200,0.22384853933126592,11,179,22,4.110848241542893e-5,1,0.04953327459088857,0.03141346513877519,2015-05-01,-1,82873,5
Kenya,201505,2,1714,857,1700,0,0,0,0,-1,2,0,0,1.1346811075163907e-8,1,0,0.0016741606059469752,2015-05-01,2,1714,5
Russian Federation,201505,2,2622,1311,2522,11,12122459,1102041.72727273,5770225,0.9995675080438637,13,15,6,5.609179179545956e-4,1,11.840690376317015,0.0025610554893774617,2015-05-01,-9,12125081,5
Ukraine,201505,1,908800,908800,908800,0,0,0,0,-1,1,0,0,6.0637905707618635e-6,1,0,0.8876762886141255,2015-05-01,1,908800,5
Peru,201505,1,9937,9937,9937,0,0,0,0,-1,1,0,0,9.441159560499985e-13,2,0,0.009706029137278352,2015-05-01,1,9937,5
Guatemala,201505,2,7842,3921,7533,0,0,0,0,-1,2,0,0,2.919423269168967e-9,2,0,0.007659724312623209,2015-05-01,2,7842,5
Honduras,201505,2,23348,11674,23241,0,0,0,0,-1,2,0,0,1.0109338793078486e-9,2,0,0.022805310284509904,2015-05-01,2,23348,5
Latvia,201505,2,26032,13016,24598,8,249198,31149.75,114864,0.8108345747193256,10,69,19,0.001330200770846377,1,0.24340576119065013,0.025426924675619404,2015-05-01,-6,275230,5
Lithuania,201505,6,167439,27906.5,114864,6,716521,119420.166666667,424908,0.6211615910222182,12,281,25,0.006699039455955916,1,0.6998665294829245,0.16354712817920397,2015-05-01,0,883960,5
Norway,201505,1,34068,34068,34068,5,289433,57886.6,249141,0.7893793218568104,6,43,10,0.008054188053521745,1,0.2827055581453039,0.033276139745275116,2015-05-01,-4,323501,5
Croatia,201505,2,53546,26773,47983,11,640474,58224.9090909091,271796,0.8456932076885393,13,86,35,0.0027403884797120672,1,0.6255871294826623,0.05230140245393042,2015-05-01,-9,694020,5
Ireland,201505,1,10449,10449,10449,10,912799,91279.9,574668,0.9773646950765125,11,39,31,0.024151655961841156,1,0.891582337775842,0.010206128454807435,2015-05-01,-9,923248,5
Cyprus,201505,1,6991,6991,6991,2,33722,16861,27815,0.6565716110333308,3,44,3,1.9367538403199891e-4,1,0.03293818200335117,0.0068285045485270155,2015-05-01,-1,40713,5
Bosnia Herzegovina,201505,1,15866,15866,15866,4,103554,25888.5,69308,0.7342823647630212,5,0,6,3.4807631555336884e-5,1,0.1011470404832165,0.015497218304524335,2015-05-01,-3,119420,5
Slovenia,201505,2,9764,4882,5248,11,391961,35632.8181818182,138502,0.9513896322110896,13,628,41,0.0010136733694801254,1,0.38285044648050315,0.009537050266316375,2015-05-01,-9,401725,5
Mauritius,201505,1,27,27,27,1,159,159,159,0.7096774193548387,2,43,0,9.231922986303923e-8,1,1.5530428024829e-4,2.637242494782283e-5,2015-05-01,0,186,5
Rwanda,201505,1,477,477,477,0,0,0,0,-1,1,0,0,1.6218090207314148e-6,1,0,4.6591284074487e-4,2015-05-01,1,477,5
Saint-Barthélemy,201505,1,8764,8764,8764,0,0,0,0,-1,1,0,0,2.9797765739338724e-5,1,0,0.00856029378676738,2015-05-01,1,8764,5
South Africa,201505,3,45464,15154.6666666667,39110,0,0,0,0,-1,3,0,0,1.0812076449326046e-6,1,0,0.04440725658621545,2015-05-01,3,45464,5
Suriname,201505,1,2275,2275,2275,0,0,0,0,-1,1,0,0,7.061042786173927e-5,1,0,0.0022221209909739606,2015-05-01,1,2275,5
Trinidad and Tobago,201505,1,2131,2131,2131,0,0,0,0,-1,1,0,0,8.969347590491299e-14,1,0,0.0020814680579189057,2015-05-01,1,2131,5
Uganda,201505,1,1039,1039,1039,1,14,14,14,-0.97340930674264,2,44,0,8.959142785298755e-6,1,1.3674590713685913e-5,0.0010148499822514045,2015-05-01,0,1053,5
"China, Hong Kong SAR",201505,2,2125,1062.5,1988,10,222866,22286.6,162342,0.9811103555253321,12,74,20,1.2114982921728606e-5,1,0.21768580957116604,0.0020756075190416115,2015-05-01,-8,224991,5
Viet Nam,201505,1,8275,8275,8275,0,0,0,0,-1,1,0,0,3.1954756844529035e-9,1,0,0.008082659868267924,2015-05-01,1,8275,5
Uzbekistan,201505,3,2534988,844996,2531851,0,0,0,0,-1,3,0,2,4.656785421814186e-7,1,0,2.4760659545789445,2015-05-01,3,2534988,5
Afghanistan,201505,1,583,583,583,0,0,0,0,-1,1,0,0,1.0988968720154621e-13,1,0,5.694490275770633e-4,2015-05-01,1,583,5
Armenia,201505,1,308175,308175,308175,0,0,0,0,-1,1,0,0,5.365178308817582e-6,1,0,0.30101192808501115,2015-05-01,1,308175,5
Belarus,201505,1,5770225,5770225,5770225,9,1015500,112833.333333333,908800,-0.7006952094286167,10,2,7,2.1497523525733234e-4,1,0.9918962049820031,5.636104657205593,2015-05-01,-8,6785725,5
Georgia,201505,1,88279,88279,88279,1,339585,339585,339585,0.5873501860404241,2,0,1,2.5628081344471116e-5,1,0.33169184910764504,0.08622708525810562,2015-05-01,0,427864,5
Kazakhstan,201505,1,173223,173223,173223,7,2730001,390000.142857143,2531851,0.8806685257493049,8,8,4,5.674311095497738e-6,1,2.6665461659252325,0.16919668765691534,2015-05-01,-6,2903224,5
Bangladesh,201505,1,8361,8361,8361,0,0,0,0,-1,1,0,0,1.3930396424967782e-8,1,0,0.008166660925509137,2015-05-01,1,8361,5
Pakistan,201505,1,3645,3645,3645,1,583,583,583,-0.7242194891201513,2,1,0,6.072993053072758e-9,1,5.694490275770633e-4,0.003560277367956082,2015-05-01,0,4228,5
Saudi Arabia,201505,1,2512,2512,2512,0,0,0,0,-1,1,0,0,4.1852835546980394e-9,1,0,0.0024536122766270724,2015-05-01,1,2512,5
Argentina,201505,1,46,46,46,0,0,0,0,-1,1,0,0,4.346066493115192e-10,2,0,4.493079805925371e-5,2015-05-01,1,46,5
Canada,201505,1,11960,11960,11960,11,2122963,192996.636363636,1130551,0.9887958488432604,12,0,0,3.0440451873036604e-4,2,2.0736178660927704,0.011682007495405966,2015-05-01,-10,2134923,5
Chile,201505,1,324,324,324,1,9937,9937,9937,0.9368482604034695,2,1,0,3.061142782074302e-9,2,0.009706029137278352,3.16469099373874e-4,2015-05-01,0,10261,5
Mexico,201505,1,1130551,1130551,1130551,0,0,0,0,-1,1,0,0,1.0681412707008174e-5,2,0,1.1042730147105944,2015-05-01,1,1130551,5
Kyrgyzstan,201505,1,3480,3480,3480,1,2001,2001,2001,-0.2698412698412698,2,0,1,6.418076652458324e-10,1,0.0019544897155775363,0.003399112548830498,2015-05-01,0,5481,5
Turkmenistan,201505,1,52767,52767,52767,0,0,0,0,-1,1,0,0,9.293150873594475e-9,1,0,0.051540509156361755,2015-05-01,1,52767,5
Finland,201505,1,11,11,11,5,270239,54047.8,225504,0.9999185938945421,6,106,8,0.007101503772332884,1,0.2639576942768405,1.074432127503893e-5,2015-05-01,-4,270250,5
Seychelles,201505,0,0,0,0,6,15219,2536.5,7475,1,6,0,2,2.371128205850007e-4,1,0.014865256862256135,0,2015-05-01,-6,15219,5
Paraguay,201505,0,0,0,0,1,19576,19576,19576,1,1,0,0,2.162345833940416e-7,1,0.0191209848436511,0,2015-05-01,-1,19576,5
Switzerland,201505,0,0,0,0,11,641899,58354.4545454545,303918,1,11,0,23,0.011084182156700229,1,0.6269790074660195,0,2015-05-01,-11,641899,5
Montenegro,201505,0,0,0,0,2,154564,77282,153834,1,2,0,1,3.847959998366018e-7,1,0.15097138850501066,0,2015-05-01,-2,154564,5
Iceland,201505,0,0,0,0,1,366,366,366,1,1,0,0,1.1359743559293351e-5,1,3.574928715149317e-4,0,2015-05-01,-1,366,5
Azerbaijan,201505,0,0,0,0,1,267540,267540,267540,1,1,0,0,2.758379280653858e-8,1,0.2613214285385378,0,2015-05-01,-1,267540,5
Antigua and Barbuda,201505,0,0,0,0,2,1269,634.5,1160,1,2,0,0,6.991203773538969e-9,1,0.0012395039725476731,0,2015-05-01,-2,1269,5
El Salvador,201505,0,0,0,0,2,30774,15387,23241,1,2,0,0,1.4118086003387293e-12,2,0.030058703901640733,0,2015-05-01,-2,30774,5
Barbados,201505,0,0,0,0,2,2356,1178,2131,1,2,0,0,1.3560524641738625e-9,1,0.0023012382658174294,0,2015-05-01,-2,2356,5
Malta,201505,0,0,0,0,2,10671,5335.5,9489,1,2,0,1,4.181339828164356e-5,1,0.010422968393267312,0,2015-05-01,-2,10671,5
Rep. of Moldova,201505,0,0,0,0,2,200410,100205,187392,1,2,0,0,1.1187417775535962e-4,1,0.19575176606641384,0,2015-05-01,-2,200410,5
Singapore,201505,0,0,0,0,12,1008523,84043.5833333333,886885,1,12,0,19,5.500207743014903e-5,1,0.9850813750241898,0,2015-05-01,-12,1008523,5
Mozambique,201505,0,0,0,0,1,6036,6036,6036,1,1,0,0,2.0255630607313664e-10,1,0.005895702110557726,0,2015-05-01,-1,6036,5
Bermuda,201505,0,0,0,0,1,15364,15364,15364,1,1,0,0,9.259728866474498e-8,1,0.01500688655179074,0,2015-05-01,-1,15364,5
Greenland,201505,0,0,0,0,3,17006,5668.66666666667,14591,1,3,0,3,1.969099894029593e-5,1,0.01661072069121019,0,2015-05-01,-3,17006,5
Kuwait,201505,0,0,0,0,8,198260,24782.5,173419,1,8,0,0,5.368065546654889e-5,1,0.19365173963538349,0,2015-05-01,-8,198260,5
Saint Vincent and the Grenadines,201505,0,0,0,0,1,300,300,300,1,1,0,0,1.8080699408910217e-9,1,2.930269438646981e-4,0,2015-05-01,-1,300,5
Botswana,201505,0,0,0,0,1,39110,39110,39110,1,1,0,0,1.3124548293071262e-9,1,0.03820094591516115,0,2015-05-01,-1,39110,5
Senegal,201505,0,0,0,0,1,15383,15383,15383,1,1,0,0,4.625393128538281e-10,1,0.015025444924902171,0,2015-05-01,-1,15383,5
Rep. of Korea,201506,4,9227,2306.75,5488,0,0,0,0,-1,4,0,3,2.801305195970666e-9,1,0,0.011025875346105753,2015-06-01,4,9227,6
Denmark,201506,7,48891,6984.42857142857,22612,22,1605301,72968.2272727273,1291068,0.9408883612059543,29,838,126,0.05294074042514877,2,1.9182669035416615,0.058422680345340455,2015-06-01,-15,1654192,6
Germany,201506,24,3084932,128538.833333333,674833,22,34846333,1583924.22727273,20309436,0.8373409376143928,46,1505,171,0.9266495388032425,2,41.63989638310299,3.686363464095883,2015-06-01,2,37931265,6
Netherlands,201506,33,42925537,1300773.84848485,20309436,6,1682028,280338,1142380,-0.9245855271409681,39,1188,135,1,2,2.0099524283797083,51.294203980345756,2015-06-01,27,44607565,6
Poland,201506,14,953628,68116.2857142857,257917,6,1067328,177888,315248,0.05626050245527364,20,0,73,0.02605675655354497,2,1.2754118870064335,1.1395451885288974,2015-06-01,8,2020956,6
Spain,201506,28,16285544,581626.571428571,9653364,11,128634,11694,51703,-0.9843264767812314,39,455,146,0.3901950339622897,2,0.153712197818464,19.460537345564155,2015-06-01,17,16414178,6
Sweden,201506,4,35105,8776.25,17952,11,964595,87690.4545454545,695785,0.9297689306792037,15,0,61,0.030156780976908056,2,1.15265029039524,0.04194899252466051,2015-06-01,-7,999700,6
Turkey,201506,12,439196,36599.6666666667,173207,0,0,0,0,-1,12,0,26,0.003995672447377765,3,0,0.5248206728631476,2015-06-01,12,439196,6
Albania,201506,4,38638,9659.5,20908,0,0,0,0,-1,4,0,5,1.2420984795798527e-6,4,0,0.0461707783269572,2015-06-01,4,38638,6
Austria,201506,10,1756453,175645.3,1093602,12,1994063,166171.916666667,553586,0.0633539491632618,22,171,88,0.0597631329459179,2,2.3828210762199715,2.098887160430637,2015-06-01,-2,3750516,6
Bosnia Herzegovina,201506,3,134770,44923.3333333333,74960,2,11753,5876.5,9674,-0.8395746742832183,5,0,10,0.0025808047349794583,4,0.014044338673759718,0.161044458696724,2015-06-01,1,146523,6
Italy,201506,16,359297,22456.0625,85363,7,825840,117977.142857143,354416,0.39366166105690736,23,1503,76,0.016187844963933804,2,0.9868439249840658,0.4293447419778648,2015-06-01,9,1185137,6
Serbia,201506,6,585557,97592.8333333333,553586,4,533726,133431.5,500973,-0.046307323527651184,10,199,22,0.0013153183060319285,4,0.6377800308849723,0.6997158870748506,2015-06-01,2,1119283,6
Slovenia,201506,3,2869,956.333333333333,2096,14,307827,21987.6428571429,128273,0.9815317866982517,17,1836,43,6.032228251630644e-4,4,0.3678402655430471,0.0034283338428500493,2015-06-01,-11,310696,6
TFYR of Macedonia,201506,14,1668661,119190.071428571,504080,1,4330,4330,4330,-0.9948236422072803,15,47,39,0.003014316513273691,4,0.005174167145186725,1.9939794278647633,2015-06-01,13,1672991,6
Trinidad and Tobago,201506,2,2607,1303.5,2579,0,0,0,0,-1,2,0,1,6.167603980715255e-14,5,0,0.003115254907044294,2015-06-01,2,2607,6
United States of America,201506,8,1381709,172713.625,1370096,0,0,0,0,-1,8,0,5,8.08665897959011e-5,5,0,1.6510839057757054,2015-06-01,8,1381709,6
Estonia,201506,3,30054,10018,26314,10,144781,14478.1,48078,0.6562015614722453,13,223,39,0.0032569846529538473,2,0.17300718093470652,0.035913260827122824,2015-06-01,-7,174835,6
Latvia,201506,2,26375,13187.5,19518,7,241346,34478,135276,0.8029665211171332,9,0,18,0.0016772433006115013,2,0.288398278018992,0.03151701119036949,2015-06-01,-5,267721,6
Portugal,201506,7,9273,1324.71428571429,6021,2,93627,46813.5,54487,0.8197667638483965,9,0,15,0.0022285602909839133,3,0.11188031115528811,0.011080843403537297,2015-06-01,5,102900,6
Brazil,201506,1,36935,36935,36935,0,0,0,0,-1,1,0,0,0,6,0,0.04413576524421979,2015-06-01,1,36935,6
Luxembourg,201506,1,10464,10464,10464,8,173473,21684.125,110448,0.8862219129375819,9,0,18,0.0025512024679427646,2,0.20729290927874752,0.01250403810790621,2015-06-01,-7,183937,6
Belgium,201506,12,3778882,314906.833333333,1860603,6,4783757,797292.833333333,3859883,0.11735575912986639,18,81,60,0.26591283041354147,2,5.7163875981424965,4.515604408761548,2015-06-01,6,8562639,6
Costa Rica,201506,2,566,283,301,0,0,0,0,-1,2,0,0,9.12060709201652e-6,7,0,6.763460979620523e-4,2015-06-01,2,566,6
France,201506,15,991826,66121.7333333333,623145,18,5150661,286147.833333333,2714739,0.6770604479911801,33,409,102,0.14293794758111011,3,6.154822383878661,1.1851901854369442,2015-06-01,-3,6142487,6
Greece,201506,9,76775,8530.55555555555,26758,3,12874,4291.33333333333,11442,-0.7127909959954936,12,395,31,5.053373186462977e-4,2,0.015383886334211061,0.09174288281101867,2015-06-01,6,89649,6
Hungary,201506,9,1155496,128388.444444444,463030,5,254633,50926.6,194124,-0.6388514809637984,14,136,46,0.018373247558812335,2,0.3042756819123167,1.3807689236939216,2015-06-01,4,1410129,6
Jordan,201506,7,67764,9680.57142857143,34212,0,0,0,0,-1,7,0,10,7.93824601245536e-4,8,0,0.08097511834328712,2015-06-01,7,67764,6
Romania,201506,12,2247616,187301.333333333,872961,6,46602,7767,12682,-0.9593743924945232,18,117,53,0.032600352662697146,2,0.05568742200923597,2.685806203740417,2015-06-01,6,2294218,6
Russian Federation,201506,3,10460,3486.66666666667,8600,8,3457520,432190,1580985,0.9939676699404264,11,590,5,3.309515509294524e-6,9,4.131590389798154,0.012499258276825206,2015-06-01,-5,3467980,6
Thailand,201506,4,326046,81511.5,259362,0,0,0,0,-1,4,0,4,2.2221587674078996e-5,1,0,0.38961120115924963,2015-06-01,4,326046,6
Ukraine,201506,4,108487,27121.75,92600,0,0,0,0,-1,4,0,1,3.192086719845532e-5,7,0,0.1296373836212176,2015-06-01,4,108487,6
Egypt,201506,4,5232,1308,2500,0,0,0,0,-1,4,0,0,6.495823985703808e-5,8,0,0.006252019053953105,2015-06-01,4,5232,6
Dominica,201506,1,23,23,23,0,0,0,0,-1,1,0,0,2.240539542567195e-15,5,0,2.7484028715772442e-5,2015-06-01,1,23,6
Peru,201506,1,9644,9644,9644,0,0,0,0,-1,1,0,0,1.0550040784563463e-12,7,0,0.01152417273630041,2015-06-01,1,9644,6
Guatemala,201506,2,13454,6727,13249,0,0,0,0,-1,2,0,0,1.2099474138401748e-8,7,0,0.016076961840956628,2015-06-01,2,13454,6
Honduras,201506,2,17505,8752.5,17309,0,0,0,0,-1,2,0,0,1.1568280009324223e-8,7,0,0.02091773576824333,2015-06-01,2,17505,6
Dominican Rep.,201506,4,5096,1274,3995,0,0,0,0,-1,4,0,1,2.443270308117417e-6,3,0,0.0060895047971989726,2015-06-01,4,5096,6
India,201506,8,165260,20657.5,130095,0,0,0,0,-1,8,0,1,1.3748086927394682e-6,8,0,0.19747872111167625,2015-06-01,8,165260,6
Japan,201506,3,47170,15723.3333333333,41616,1,2529,2529,2529,-0.8982273285176764,4,0,5,2.6375047390167636e-8,1,0.003022048200964718,0.056366158022738526,2015-06-01,2,49699,6
China,201506,5,1796802,359360.4,1580985,0,0,0,0,-1,5,0,4,2.792947179969384e-7,9,0,2.1471025115024935,2015-06-01,5,1796802,6
Malaysia,201506,2,860397,430198.5,855333,13,282706,21746.6153846154,259362,-0.5053709070836137,15,7,19,1.1918712227917772e-5,1,0.33782173139657234,1.0281380806506288,2015-06-01,-11,1143103,6
Australia,201506,5,71792,14358.4,49921,0,0,0,0,-1,5,0,4,2.0681892622904984e-8,1,0,0.08578840824185804,2015-06-01,5,71792,6
Viet Nam,201506,2,1153,576.5,997,0,0,0,0,-1,2,0,1,5.052633591034762e-10,1,0,0.001377786309099375,2015-06-01,2,1153,6
New Zealand,201506,1,686,686,686,1,49921,49921,49921,0.9728891260102357,2,0,1,3.230914379796992e-10,1,0.05965348684869896,8.197410303921694e-4,2015-06-01,0,50607,6
Finland,201506,3,2669,889.666666666667,2660,6,301125,50187.5,194833,0.9824288827297445,9,50,24,0.008965754872875067,3,0.3598316585668251,0.003189342288799854,2015-06-01,-3,303794,6
Lithuania,201506,5,194039,38807.8,135276,6,324053,54008.8333333333,230194,0.25094770812905814,11,32,25,0.002344647636540875,2,0.38722965032313944,0.2318684107817291,2015-06-01,-1,518092,6
South Africa,201506,5,55587,11117.4,47e3,0,0,0,0,-1,5,0,1,2.666686167494677e-6,3,0,0.06642411757494099,2015-06-01,5,55587,6
United Kingdom,201506,7,115827,16546.7142857143,54977,13,14309182,1100706.30769231,12424698,0.9839408072466367,20,115,61,0.4853861456863581,2,17.0988682168354,0.13840837365485978,2015-06-01,-6,14425009,6
Lebanon,201506,4,6188,1547,2849,0,0,0,0,-1,4,0,2,4.902890118349148e-5,3,0,0.007394398682313038,2015-06-01,4,6188,6
Mauritius,201506,1,33,33,33,0,0,0,0,-1,1,0,0,1.748546057082725e-7,3,0,3.94336064182822e-5,2015-06-01,1,33,6
Kenya,201506,1,2100,2100,2100,0,0,0,0,-1,1,0,0,3.33487719742424e-10,9,0,0.002509411317527049,2015-06-01,1,2100,6
Morocco,201506,4,36724,9181,35400,0,0,0,0,-1,4,0,0,1.9013814487033928e-6,2,0,0.04388362915469683,2015-06-01,4,36724,6
Bulgaria,201506,3,171930,57310,164191,3,64216,21405.3333333333,35545,-0.45613307021927113,6,0,4,4.5694084710601524e-4,2,0.07673540817443666,0.20544908943925025,2015-06-01,0,236146,6
Slovakia,201506,4,222104,55526,185099,11,960792,87344.7272727273,306838,0.6244741718629533,15,0,50,0.01615121721113226,2,1.1481058659949754,0.2654049006038227,2015-06-01,-7,1182896,6
Czech Rep.,201506,3,17133,5711,13215,17,4625679,272098.764705882,1703231,0.9926195590086353,20,194,87,0.0690280464559689,2,5.527491063736763,0.020473211477709967,2015-06-01,-14,4642812,6
Norway,201506,2,41639,20819.5,41212,7,295525,42217.8571428571,200527,0.7530044726008708,9,0,24,0.009178641918284637,3,0.3531398950534196,0.04975684659548038,2015-06-01,-5,337164,6
"China, Hong Kong SAR",201506,2,561,280.5,311,10,254356,25435.6,194006,0.9955985673768325,12,62,17,1.120027901389122e-5,1,0.30394467860995716,6.703713091107974e-4,2015-06-01,-8,254917,6
Indonesia,201506,2,438,219,423,0,0,0,0,-1,2,0,1,2.1479329342041023e-10,1,0,5.233915033699273e-4,2015-06-01,2,438,6
Singapore,201506,1,87,87,87,13,962868,74066.7692307692,855333,0.999819306198109,14,9,17,5.018266297971626e-5,1,1.1505865983260166,1.039613260118349e-4,2015-06-01,-12,962955,6
Iran,201506,2,93105,46552.5,92570,0,0,0,0,-1,2,0,0,2.893139675024985e-9,9,0,0.1112565431992171,2015-06-01,2,93105,6
Cyprus,201506,1,785,785,785,2,3791,1895.5,2516,0.6569055944055944,3,135,1,2.472725010005924e-5,2,0.0045300849070214495,9.38041849647016e-4,2015-06-01,-1,4576,6
Croatia,201506,1,57545,57545,57545,10,476980,47698,229494,0.784687339226416,11,0,28,0.0023073048111334708,4,0.5699709572543105,0.0687638448890924,2015-06-01,-9,534525,6
Ecuador,201506,1,247,247,247,0,0,0,0,-1,1,0,0,3.572681371722594e-6,2,0,2.9515456925199103e-4,2015-06-01,1,247,6
Ireland,201506,1,11634,11634,11634,9,670310,74478.8888888889,364808,0.9658798962964701,10,0,25,0.02065509628664813,8,0.8009921429769316,0.013902138699099852,2015-06-01,-8,681944,6
Suriname,201506,1,3196,3196,3196,0,0,0,0,-1,1,0,0,1.1847381271678083e-4,2,0,0.0038190850337221187,2015-06-01,1,3196,6
Afghanistan,201506,1,31537,31537,31537,0,0,0,0,-1,1,0,0,6.986066157084398e-13,8,0,0.03768538320040502,2015-06-01,1,31537,6
Uganda,201506,1,751,751,751,0,0,0,0,-1,1,0,0,7.402779680513738e-6,2,0,8.974132854584828e-4,2015-06-01,1,751,6
Nepal,201506,1,27,27,27,0,0,0,0,-1,1,0,0,5.022650754739487e-11,1,0,3.2263859796776344e-5,2015-06-01,1,27,6
Armenia,201506,1,200766,200766,200766,0,0,0,0,-1,1,0,0,2.4630327212788197e-8,9,0,0.2399068917022074,2015-06-01,1,200766,6
Belarus,201506,1,1470965,1470965,1470965,6,168100,28016.6666666667,92600,-0.7948830583289863,7,47,1,4.283955597419123e-6,9,0.20087240117918903,1.7577410565172265,2015-06-01,-5,1639065,6
Kazakhstan,201506,1,182533,182533,182533,7,128781,18397.2857142857,82639,-0.17266168562930032,8,269,2,1.0236443415866407e-6,9,0.1538878566106909,0.21811922667722136,2015-06-01,-6,311314,6
Uzbekistan,201506,2,87055,43527.5,82639,0,0,0,0,-1,2,0,1,3.6775726485824967e-9,9,0,0.1040270486891987,2015-06-01,2,87055,6
Bangladesh,201506,1,14937,14937,14937,0,0,0,0,-1,1,0,0,7.06176268973499e-9,8,0,0.017849084214238826,2015-06-01,1,14937,6
Sri Lanka,201506,1,606,606,606,0,0,0,0,-1,1,0,0,2.8649850444891925e-10,8,0,7.241444087720913e-4,2015-06-01,1,606,6
Pakistan,201506,1,1264,1264,1264,1,31537,31537,31537,0.9229291789884455,2,1,0,5.975818479184561e-10,8,0.03768538320040502,0.0015104266215972334,2015-06-01,0,32801,6
Saudi Arabia,201506,1,7674,7674,7674,0,0,0,0,-1,1,0,0,3.628035540683094e-9,8,0,0.009170105928905988,2015-06-01,1,7674,6
Barbados,201506,1,517,517,517,2,2784,1392,2579,0.6867615873977583,3,0,2,6.145776548696525e-10,5,0.0033267624323787166,6.177931672197545e-4,2015-06-01,-1,3301,6
Canada,201506,2,30031,15015.5,29997,15,2198784,146585.6,1370096,0.9730520478370793,17,65,2,0.0015921970121588848,7,2.6274540259035213,0.03588577679840705,2015-06-01,-13,2228815,6
United Arab Emirates,201506,1,3183,3183,3183,0,0,0,0,-1,1,0,0,1.6804137539949143e-8,3,0,0.0038035505827088557,2015-06-01,1,3183,6
Kyrgyzstan,201506,1,21450,21450,21450,0,0,0,0,-1,1,0,0,8.139392295296579e-10,9,0,0.02563184417188343,2015-06-01,1,21450,6
Turkmenistan,201506,1,8848,8848,8848,0,0,0,0,-1,1,0,0,3.357451883973069e-10,9,0,0.010572986351180633,2015-06-01,1,8848,6
Argentina,201506,1,209,209,209,0,0,0,0,-1,1,0,0,1.2335554744796622e-8,7,0,2.4974617398245395e-4,2015-06-01,1,209,6
Chile,201506,1,50,50,50,1,9644,9644,9644,0.989684340829379,2,2,0,2.9510900275335413e-9,7,0.01152417273630041,5.974788851254879e-5,2015-06-01,0,9694,6
Mexico,201506,1,667338,667338,667338,0,0,0,0,-1,1,0,0,3.9387485338528184e-5,7,0,0.7974407284837457,2015-06-01,1,667338,6
Mozambique,201506,1,11499,11499,11499,1,7733,7733,7733,-0.19581946755407653,2,0,0,6.794560245192154e-7,7,0.009240608437350795,0.01374081940011597,2015-06-01,0,19232,6
Montenegro,201506,0,0,0,0,3,27368,9122.66666666667,20908,1,3,0,3,6.634681107422105e-7,4,0.0327036042562287,0,2015-06-01,-3,27368,6
Paraguay,201506,0,0,0,0,1,36935,36935,36935,1,1,0,0,0,6,0.04413576524421979,0,2015-06-01,-1,36935,6
Antigua and Barbuda,201506,0,0,0,0,2,901,450.5,878,1,2,0,0,2.631959725094488e-9,5,0.0010766569509961291,0,2015-06-01,-2,901,6
El Salvador,201506,0,0,0,0,2,30558,15279,17309,1,2,0,0,1.3365052537066223e-11,7,0.036515519543329315,0,2015-06-01,-2,30558,6
Switzerland,201506,0,0,0,0,11,405003,36818.4545454545,129258,1,11,0,25,0.0022223115448213922,3,0.4839614818249559,0,2015-06-01,-11,405003,6
Iceland,201506,0,0,0,0,2,473,236.5,426,1,2,0,1,1.588380241287258e-5,2,5.652150253287116e-4,0,2015-06-01,-2,473,6
Azerbaijan,201506,0,0,0,0,2,92728,46364,92570,1,2,0,0,8.371925855005462e-7,9,0.11080604411983248,0,2015-06-01,-2,92728,6
Malta,201506,0,0,0,0,2,10495,5247.5,7748,1,2,0,1,1.0647902210068301e-4,2,0.012541081798783991,0,2015-06-01,-2,10495,6
Rep. of Moldova,201506,0,0,0,0,1,31338,31338,31338,1,1,0,0,3.787120892407403e-5,2,0.03744758660412508,0,2015-06-01,-1,31338,6
Cabo Verde,201506,0,0,0,0,2,763,381.5,727,1,2,0,1,1.0518517966851271e-5,3,9.117527787014945e-4,0,2015-06-01,-2,763,6
Bermuda,201506,0,0,0,0,1,9556,9556,9556,1,1,0,0,2.8645794003930548e-8,5,0.011419016452518324,0,2015-06-01,-1,9556,6
Greenland,201506,0,0,0,0,2,22681,11340.5,22367,1,2,0,1,4.843661642942559e-5,2,0.02710283718706238,0,2015-06-01,-2,22681,6
Kuwait,201506,0,0,0,0,9,170607,18956.3333333333,130095,1,9,0,0,1.2753639695987192e-5,8,0.2038681603092082,0,2015-06-01,-9,170607,6
Saint Vincent and the Grenadines,201506,0,0,0,0,4,850,212.5,517,1,4,0,3,2.8191229775830255e-9,5,0.0010157141047133294,0,2015-06-01,-4,850,6
Seychelles,201506,0,0,0,0,8,8981,1122.625,3765,1,8,0,3,1.4241770874391e-4,3,0.010731915734624013,0,2015-06-01,-8,8981,6
Botswana,201506,0,0,0,0,1,47e3,47e3,47e3,1,1,0,0,4.6460658471058904e-9,3,0.05616301520179586,0,2015-06-01,-1,47e3,6
Cameroon,201507,1,8975,8975,8975,0,0,0,0,-1,1,0,0,3.8330190190379005e-6,1,0,0.008437664385989493,2015-07-01,1,8975,7
Croatia,201507,2,23641,11820.5,23297,10,903108,90310.8,556129,0.9489807919943803,12,45,34,0.0026183907946330477,1,0.849038686161805,0.022225607102972438,2015-07-01,-8,926749,7
Czech Rep.,201507,5,56849,11369.8,29812,18,5458919,303273.277777778,1264616,0.9793867327269747,23,431,88,0.06760617091945455,1,5.132092081593468,0.05344543539600186,2015-07-01,-13,5515768,7
Germany,201507,23,6436106,279830.695652174,1353022,25,42541791,1701671.64,24426204,0.7371832441070305,48,805,159,0.8660247963476022,1,39.99480276734355,6.050774638512902,2015-07-01,-2,48977897,7
Greece,201507,6,57394,9565.66666666667,27567,3,130416,43472,80346,0.3888078377083222,9,3,12,2.4758937949730374e-4,1,0.1226079597284909,0.053957806102449136,2015-07-01,3,187810,7
Heard Island and McDonald Islands,201507,1,113982,113982,113982,0,0,0,0,-1,1,0,0,4.8679128003123433e-5,1,0,0.10715786763719827,2015-07-01,1,113982,7
Hungary,201507,10,3912897,391289.7,1264616,4,652590,163147.5,569208,-0.714120311809014,14,0,54,0.030727338913241305,1,0.6135192648081207,3.6786308259548894,2015-07-01,6,4565487,7
Romania,201507,10,1749563,174956.3,785295,4,75840,18960,61765,-0.9169060202048533,14,124,44,0.0211735788910086,1,0.07129943922378197,1.6448162023559818,2015-07-01,6,1825403,7
Slovakia,201507,4,332659,83164.75,276197,14,1252657,89475.5,304097,0.5803246797483909,18,125,44,0.0145851367342202,1,1.1776600954607734,0.31274261804778597,2015-07-01,-10,1585316,7
Austria,201507,11,3399140,309012.727272727,2048789,14,3230471,230747.928571429,923532,-0.025441764230208982,25,0,88,0.0712321289764932,1,3.037061850325556,3.195632592868226,2015-07-01,-3,6629611,7
Bulgaria,201507,6,626475,104412.5,314068,3,25181,8393.66666666667,11337,-0.9227168935757516,9,71,17,0.00800722395080042,1,0.02367340689733721,0.5889677767367987,2015-07-01,3,651656,7
Netherlands,201507,30,55207102,1840236.73333333,24426204,7,4948134,706876.285714286,3579363,-0.8354878368360154,37,250,122,1,1,4.651887914083982,51.90183826173698,2015-07-01,23,60155236,7
Poland,201507,17,1679756,98809.1764705882,509945,8,2642472,330309,1353022,0.22273605186954507,25,205,82,0.04759371326520476,1,2.4842665053341983,1.5791885658331106,2015-07-01,9,4322228,7
Spain,201507,25,13477637,539105.48,9182114,11,327714,29792.1818181818,152306,-0.9525236265271343,36,500,136,0.2766247569103962,1,0.30809367650029645,12.670727322807162,2015-07-01,14,13805351,7
Sweden,201507,4,56388,14097,31211,10,1738900,173890,1347402,0.9371822236877871,14,0,46,0.04460803143145528,1,1.6347915989746107,0.053012035587429035,2015-07-01,-6,1795288,7
Thailand,201507,5,342305,68461,258421,0,0,0,0,-1,5,0,4,2.0272053602040448e-5,2,0,0.3218111094870344,2015-07-01,5,342305,7
Turkey,201507,14,431271,30805.0714285714,113816,0,0,0,0,-1,14,0,43,0.0038270335659990064,1,0,0.4054506916334345,2015-07-01,14,431271,7
TFYR of Macedonia,201507,10,1073130,107313,436717,0,0,0,0,-1,10,0,25,0.0032696032523486405,1,0,1.0088814242380952,2015-07-01,10,1073130,7
Egypt,201507,3,3097,1032.33333333333,1951,0,0,0,0,-1,3,0,0,4.947733490857559e-5,2,0,0.0029115817942517506,2015-07-01,3,3097,7
United States of America,201507,10,496869,49686.9,482183,0,0,0,0,-1,10,0,5,3.869529492873834e-6,2,0,0.46712132209495416,2015-07-01,10,496869,7
Belgium,201507,13,7404369,569566.846153846,3579363,9,10447827,1160869.66666667,9111448,0.17048087529399744,22,180,64,0.45502436483440684,1,9.8223128455576,6.961067477662913,2015-07-01,4,17852196,7
Albania,201507,1,2252,2252,2252,0,0,0,0,-1,1,0,0,3.0953602985003124e-11,1,0,0.0021171721668243274,2015-07-01,1,2252,7
Serbia,201507,6,1020145,170024.166666667,923532,1,105239,105239,105239,-0.8129722832384324,7,1,13,0.002012382536210533,1,0.09893831335010009,0.9590686501443177,2015-07-01,5,1125384,7
Dominican Rep.,201507,4,8676,2169,8189,0,0,0,0,-1,4,0,1,2.4676785070701836e-7,1,0,0.008156565594745945,2015-07-01,4,8676,7
France,201507,16,2168727,135545.4375,1224892,20,6431530,321576.5,2995743,0.49565995527808066,36,254,112,0.13363301559766497,1,6.046472604838218,2.038884743268394,2015-07-01,-4,8600257,7
Italy,201507,16,192841,12052.5625,83733,11,1089973,99088.4545454545,762199,0.6993469045395513,27,1436,99,0.009895458459623457,1,1.0247160293916575,0.18129555853577714,2015-07-01,5,1282814,7
Peru,201507,2,12477,6238.5,12450,0,0,0,0,-1,2,0,0,6.164937503014727e-9,1,0,0.011729998723564446,2015-07-01,2,12477,7
Portugal,201507,8,28310,3538.75,17277,2,66103,33051.5,41570,0.40029445097603084,10,0,15,0.0017642351918936094,1,0.062145395978502896,0.026615072843160174,2015-07-01,6,94413,7
India,201507,6,144851,24141.8333333333,112384,0,0,0,0,-1,6,0,0,1.1212911938178225e-6,3,0,0.13617873247631912,2015-07-01,6,144851,7
Morocco,201507,4,3611,902.75,2470,0,0,0,0,-1,4,0,2,1.1126889511728435e-5,1,0,0.003394808478864408,2015-07-01,4,3611,7
Jordan,201507,7,55372,7910.28571428571,23259,0,0,0,0,-1,7,0,10,3.427929160715435e-4,1,0,0.05205686377504292,2015-07-01,7,55372,7
Mexico,201507,2,365975,182987.5,365937,0,0,0,0,-1,2,0,0,7.410058160246734e-7,2,0,0.34406398035236824,2015-07-01,2,365975,7
Canada,201507,2,16137,8068.5,13653,7,880200,125742.857142857,482183,0.9639934533551555,9,19,1,6.915431459715011e-5,1,0.8275021941557607,0.015170873559522279,2015-07-01,-5,896337,7
Ukraine,201507,4,71163,17790.75,36845,0,0,0,0,-1,4,0,3,9.903675074995185e-5,2,0,0.06690245244570144,2015-07-01,4,71163,7
United Kingdom,201507,8,225448,28181,136591,13,15326051,1178927,13927548,0.97100626762732,21,361,67,0.41849689710563487,1,14.40847628975584,0.21195036885710966,2015-07-01,-5,15551499,7
Guatemala,201507,1,17931,17931,17931,0,0,0,0,-1,1,0,0,2.811885956924592e-14,1,0,0.01685746630698358,2015-07-01,1,17931,7
Honduras,201507,2,18035,9017.5,18031,0,0,0,0,-1,2,0,0,1.0143467719959245e-7,1,0,0.01695523979959003,2015-07-01,2,18035,7
Finland,201507,4,25668,6417,17067,6,654876,109146,561765,0.9245662293694457,10,71,20,0.015360720964088194,1,0.6156684013859894,0.02413125007906165,2015-07-01,-2,680544,7
Latvia,201507,2,8279,4139.5,6036,7,496973,70996.1428571429,345968,0.9672282346235146,9,1,16,0.0018273177512866268,1,0.46721909558756064,0.007783334089315545,2015-07-01,-5,505252,7
Lithuania,201507,6,437302,72883.6666666667,345968,6,536702,89450.3333333333,509945,0.1020529689816469,12,72,25,0.0014336216013529873,1,0.5045695098929619,0.41112061407487216,2015-07-01,0,974004,7
China,201507,6,425272,70878.6666666667,303713,0,0,0,0,-1,6,0,4,5.398805797949526e-8,2,0,0.39981085334356814,2015-07-01,6,425272,7
Australia,201507,5,35206,7041.2,12463,0,0,0,0,-1,5,0,4,9.554844443801235e-9,2,0,0.033098207506757224,2015-07-01,5,35206,7
New Zealand,201507,1,346,346,346,1,12463,12463,12463,0.9459754859864158,2,0,1,5.222483527922951e-11,2,0.01171683690725204,3.2528488886377323e-4,2015-07-01,0,12809,7
Malaysia,201507,2,874310,437155,869631,10,278117,27811.7,258421,-0.5173368898854331,12,5,15,1.1495775718509043e-5,2,0.2614660619541214,0.8219648300071838,2015-07-01,-8,1152427,7
Rep. of Korea,201507,2,946,473,684,0,0,0,0,-1,2,0,1,4.14269030997368e-10,2,0,8.893627308240737e-4,2015-07-01,2,946,7
Japan,201507,3,57469,19156.3333333333,50168,0,0,0,0,-1,3,0,3,1.3848821850407935e-8,2,0,0.05402831583269417,2015-07-01,3,57469,7
Denmark,201507,6,92322,15387,62204,21,1286368,61255.619047619,1018996,0.8660728662716056,27,464,116,0.032584870388247644,1,1.2093528090113128,0.08679465754243142,2015-07-01,-15,1378690,7
Estonia,201507,4,24671,6167.75,19851,8,614282,76785.25,488693,0.922776792659241,12,216,27,0.012709359031502146,1,0.5775047748584288,0.023193940731670953,2015-07-01,-4,638953,7
Brazil,201507,2,52177,26088.5,51763,0,0,0,0,-1,2,0,0,3.432836792641036e-8,1,0,0.049053149266604326,2015-07-01,2,52177,7
Ireland,201507,1,17737,17737,17737,9,746970,82996.6666666667,538144,0.9536109908762441,10,0,25,0.019255511776077486,1,0.7022487093484759,0.01667508113808308,2015-07-01,-8,764707,7
Lebanon,201507,4,7146,1786.5,2814,0,0,0,0,-1,4,0,2,4.122867972796378e-5,1,0,0.006718167097747178,2015-07-01,4,7146,7
Slovenia,201507,3,715148,238382.666666667,713695,12,508331,42360.9166666667,224053,-0.1690400897767759,15,1203,38,0.002045842632947158,1,0.4778970891358691,0.6723319008703749,2015-07-01,-9,1223479,7
Bosnia Herzegovina,201507,4,2423368,605842,1385320,2,57368,28684,57028,-0.9537492099118972,6,0,14,0.03594241266965078,1,0.053933362729297524,2.278280319526082,2015-07-01,2,2480736,7
Kenya,201507,1,2700,2700,2700,0,0,0,0,-1,1,0,0,1.3724247103673327e-8,2,0,0.002538350288821352,2015-07-01,1,2700,7
Russian Federation,201507,2,906,453,606,4,836247,209061.75,584616,0.997835521105461,6,58,1,2.9733810448471113e-6,2,0.7861806718429589,8.517575413600537e-4,2015-07-01,-2,837153,7
Norway,201507,1,42330,42330,42330,7,332592,47513.1428571429,166666,0.7741930321506874,8,0,19,0.008064959515181344,1,0.3126796293554337,0.03979569175029919,2015-07-01,-6,374922,7
Mauritius,201507,1,36,36,36,0,0,0,0,-1,1,0,0,1.408679782671005e-7,1,0,3.384467051761802e-5,2015-07-01,1,36,7
South Africa,201507,5,60219,12043.8,48643,0,0,0,0,-1,5,0,1,2.258281048900574e-6,2,0,0.05661367260834555,2015-07-01,5,60219,7
Suriname,201507,1,2111,2111,2111,0,0,0,0,-1,1,0,0,6.181362958009265e-5,1,0,0.0019846138739636567,2015-07-01,1,2111,7
Iran,201507,1,791,791,791,0,0,0,0,-1,1,0,0,2.662629740179863e-10,2,0,7.436426216509961e-4,2015-07-01,1,791,7
"China, Hong Kong SAR",201507,2,1737,868.5,1421,10,374208,37420.8,303713,0.9907592865977736,12,21,16,4.810550722559156e-6,2,0.35180406847380014,0.0016330053524750696,2015-07-01,-8,375945,7
Viet Nam,201507,2,998,499,697,0,0,0,0,-1,2,0,1,5.998651967336961e-10,2,0,9.382494771272996e-4,2015-07-01,2,998,7
Luxembourg,201507,2,1196,598,875,9,225984,25109.3333333333,160722,0.9894709041288846,11,251,19,0.0028317558435405205,1,0.21245427839592754,0.0011243951649741988,2015-07-01,-7,227180,7
Uganda,201507,1,1993,1993,1993,0,0,0,0,-1,1,0,0,2.6554489873437188e-5,1,0,0.0018736785650447978,2015-07-01,1,1993,7
Afghanistan,201507,1,34903,34903,34903,0,0,0,0,-1,1,0,0,1.4606209938251063e-12,3,0,0.032813348196567275,2015-07-01,1,34903,7
Kazakhstan,201507,1,15377,15377,15377,4,4726,1181.5,2494,-0.5298214196886037,5,6,1,1.3955120955315446e-9,2,0.004443053135173966,0.014456374959705899,2015-07-01,-3,20103,7
Armenia,201507,1,119998,119998,119998,0,0,0,0,-1,1,0,0,1.0447697465477091e-8,2,0,0.11281368813258688,2015-07-01,1,119998,7
Belarus,201507,1,584616,584616,584616,4,139400,34850,124500,-0.6149256370024971,5,102,1,1.735916186916162e-4,2,0.1310540852821098,0.5496148860924382,2015-07-01,-3,724016,7
Dominica,201507,1,127,127,127,0,0,0,0,-1,1,0,0,3.3533631177153775e-16,2,0,1.1939647654826359e-4,2015-07-01,1,127,7
Saint Kitts and Nevis,201507,1,252,252,252,0,0,0,0,-1,1,0,0,6.628741046646677e-16,2,0,2.3691269362332616e-4,2015-07-01,1,252,7
Indonesia,201507,1,7,7,7,0,0,0,0,-1,1,0,0,8.494045381616415e-12,2,0,6.580908156203505e-6,2015-07-01,1,7,7
Bangladesh,201507,1,18240,18240,18240,0,0,0,0,-1,1,0,0,1.082099099868227e-8,3,0,0.017147966395593132,2015-07-01,1,18240,7
Pakistan,201507,1,2409,2409,2409,1,34903,34903,34903,0.870872641509434,2,1,0,1.429155394680179e-9,3,0.032813348196567275,0.002264772535470606,2015-07-01,0,37312,7
Saudi Arabia,201507,1,2922,2922,2922,0,0,0,0,-1,1,0,0,1.7334942809896296e-9,3,0,0.002747059090346663,2015-07-01,1,2922,7
Barbados,201507,1,325,325,325,2,475,237.5,406,0.1875,3,49,1,8.455922083652602e-7,2,4.4656162488523784e-4,3.055421643951627e-4,2015-07-01,-1,800,7
Trinidad and Tobago,201507,1,20,20,20,0,0,0,0,-1,1,0,0,1.8196544049618328e-17,2,0,1.8802594732010012e-5,2015-07-01,1,20,7
Kyrgyzstan,201507,1,540,540,540,0,0,0,0,-1,1,0,0,2.2067208919601425e-14,2,0,5.076700577642704e-4,2015-07-01,1,540,7
Uzbekistan,201507,1,1086,1086,1086,0,0,0,0,-1,1,0,0,4.4376171924433497e-14,2,0,0.0010209808939481437,2015-07-01,1,1086,7
United Arab Emirates,201507,1,3679,3679,3679,0,0,0,0,-1,1,0,0,1.4122262744970503e-8,2,0,0.003458737300953242,2015-07-01,1,3679,7
Costa Rica,201507,1,211,211,211,0,0,0,0,-1,1,0,0,5.3506777306375996e-6,1,0,1.9836737442270564e-4,2015-07-01,1,211,7
Israel,201507,1,93329,93329,93329,0,0,0,0,-1,1,0,0,0.0023666985873112664,1,0,0.08774136818718813,2015-07-01,1,93329,7
Montenegro,201507,0,0,0,0,2,10218,5109,7966,1,2,0,0,4.694040752628734e-7,1,0.009606245648583915,0,2015-07-01,-2,10218,7
Switzerland,201507,0,0,0,0,14,625002,44643,296818,1,14,0,36,0.007797741686546931,1,0.5875829656347861,0,2015-07-01,-14,625002,7
Bolivia,201507,0,0,0,0,2,116,58,66,1,2,0,0,2.376892892307139e-11,1,1.0905504944565808e-4,0,2015-07-01,-2,116,7
El Salvador,201507,0,0,0,0,2,35962,17981,18031,1,2,0,0,5.3555293793961405e-11,1,0.033808945587627204,0,2015-07-01,-2,35962,7
Iceland,201507,0,0,0,0,2,1289,644.5,655,1,2,0,1,1.9784425992178895e-5,1,0.0012118272304780455,0,2015-07-01,-2,1289,7
Paraguay,201507,0,0,0,0,1,51763,51763,51763,1,1,0,0,5.2031772546369353e-11,1,0.04866393555565172,0,2015-07-01,-1,51763,7
Cyprus,201507,0,0,0,0,1,14827,14827,14827,1,1,0,0,1.0749327900964861e-07,1,0.013939303604575624,0,2015-07-01,-1,14827,7
Malta,201507,0,0,0,0,2,8017,4008.5,4102,1,2,0,1,1.1582636067732451e-4,1,0.007537020098326214,0,2015-07-01,-2,8017,7
Cabo Verde,201507,0,0,0,0,2,463,231.5,311,1,2,0,1,2.526964109134642e-6,1,4.3528006804603183e-4,0,2015-07-01,-2,463,7
Antigua and Barbuda,201507,0,0,0,0,4,1204,301,787,1,4,0,0,8.99965819388792e-11,2,0.0011319162028670029,0,2015-07-01,-4,1204,7
Mozambique,201507,0,0,0,0,2,11126,5563,10646,1,2,0,0,7.047390391319769e-10,2,0.01045988344941717,0,2015-07-01,-2,11126,7
Singapore,201507,0,0,0,0,14,994475,71033.9285714286,869631,1,14,0,16,4.1440090609213935e-5,2,0.9349355198057829,0,2015-07-01,-14,994475,7
Bermuda,201507,0,0,0,0,2,8788,4394,8692,1,2,0,0,2.812026279594827e-6,2,0.0082618601252452,0,2015-07-01,-2,8788,7
Greenland,201507,0,0,0,0,2,18693,9346.5,18296,1,2,0,1,2.067265678989986e-5,1,0.01757384516627316,0,2015-07-01,-2,18693,7
Rep. of Moldova,201507,0,0,0,0,1,133,133,133,1,1,0,0,8.24597330188107e-8,1,1.2503725496786658e-4,0,2015-07-01,-1,133,7
Kuwait,201507,0,0,0,0,8,161728,20216,112384,1,8,0,0,2.0260314836620847e-5,3,0.15204530204092578,0,2015-07-01,-8,161728,7
Saint Vincent and the Grenadines,201507,0,0,0,0,3,530,176.666666666667,325,1,3,0,1,2.900878495154914e-11,2,4.982687603982654e-4,0,2015-07-01,-3,530,7
Botswana,201507,0,0,0,0,1,48643,48643,48643,1,1,0,0,3.2165799716420637e-9,2,0.04573073077745815,0,2015-07-01,-1,48643,7
Seychelles,201507,0,0,0,0,7,10453,1493.28571428571,4341,1,7,0,3,1.310926937336451e-4,2,0.009827176136685033,0,2015-07-01,-7,10453,7
Chile,201507,0,0,0,0,1,12450,12450,12450,1,1,0,0,2.2474707526061165e-12,1,0.011704615220676234,0,2015-07-01,-1,12450,7
Australia,201508,4,20948,5237,14055,0,0,0,0,-1,4,0,3,4.601948458875771e-8,1,0,0.018441209240959367,2015-08-01,4,20948,8
France,201508,16,1015051,63440.6875,729320,11,3775196,343199.636363636,1259910,0.5762009766928511,27,302,75,0.05639516817597564,1,3.3234284591193832,0.8935825797806495,2015-08-01,5,4790247,8
Lebanon,201508,3,11391,3797,10222,0,0,0,0,-1,3,0,1,1.2953345430387549e-6,1,0,0.01002786969943518,2015-08-01,3,11391,8
Netherlands,201508,30,66398038,2213267.93333333,34101221,7,5170278,738611.142857143,3878789,-0.8555148901365794,37,197,120,0.9999999999999999,1,4.551564752335731,58.45236356440573,2015-08-01,23,71568316,8
South Africa,201508,3,74112,24704,64111,0,0,0,0,-1,3,0,0,8.219147291643769e-11,1,0,0.06524321650114477,2015-08-01,3,74112,8
United Arab Emirates,201508,1,4537,4537,4537,0,0,0,0,-1,1,0,0,9.32154354287589e-9,1,0,0.003994069425540989,2015-08-01,1,4537,8
Egypt,201508,4,6351,1587.75,3369,0,0,0,0,-1,4,0,1,2.9964288526131396e-5,1,0,0.005590992929603443,2015-08-01,4,6351,8
Romania,201508,10,1292792,129279.2,425232,6,119455,19909.1666666667,95461,-0.8308298760769186,16,1013,35,0.008161945542409024,1,0.10516014177385913,1.138087062107998,2015-08-01,4,1412247,8
Denmark,201508,5,98756,19751.2,36632,20,1318320,65916,1033660,0.8606200373162766,25,381,111,0.026963109391021013,1,1.1605601950802726,0.08693813537331407,2015-08-01,-15,1417076,8
Germany,201508,22,5291657,240529.863636364,1050100,23,48395898,2104169.47826087,34101221,0.8028721181286799,45,285,139,0.88795119287163,1,42.60449118875916,4.658418654209821,2015-08-01,-1,53687555,8
Lithuania,201508,7,182674,26096.2857142857,122871,5,377037,75407.4,336228,0.34725599461150486,12,74,30,9.851299736669266e-4,1,0.33191799735457306,0.16081389425639733,2015-08-01,2,559711,8
Poland,201508,15,2212964,147530.933333333,747940,10,2071734,207173.4,1050100,-0.032961482932986175,25,747,71,0.040550275474200426,1,1.823815170212417,1.9481445563638726,2015-08-01,5,4284698,8
India,201508,6,216970,36161.6666666667,179863,0,0,0,0,-1,6,0,1,2.099540473374101e-6,1,0,0.1910057842758714,2015-08-01,6,216970,8
Spain,201508,24,6943010,289292.083333333,4443701,10,1100155,110015.5,397061,-0.726437291787499,34,248,120,0.12174553981112075,1,0.9685024132369511,6.112158686847112,2015-08-01,14,8043165,8
United Kingdom,201508,8,172346,21543.25,89064,12,15874050,1322837.5,15097738,0.978519039415455,20,312,56,0.3643370806371546,1,13.974445176219737,0.15172181820901198,2015-08-01,-4,16046396,8
Guatemala,201508,1,14314,14314,14314,0,0,0,0,-1,1,0,0,7.530289923924975e-18,2,0,0.012601082159399101,2015-08-01,1,14314,8
Honduras,201508,1,14790,14790,14790,0,0,0,0,-1,1,0,0,5.02019328261665e-18,2,0,0.01302012052099432,2015-08-01,1,14790,8
Belgium,201508,12,8398720,699893.333333333,3878789,7,9858174,1408310.57142857,8876414,0.0799398846265964,19,119,53,0.3721129688719533,1,8.678472859833175,7.39366779053992,2015-08-01,5,18256894,8
Italy,201508,18,297560,16531.1111111111,155302,9,767816,85312.8888888889,356437,0.4413990929024119,27,1310,103,0.008388625951630112,1,0.675933526568477,0.26195179595855783,2015-08-01,9,1065376,8
Morocco,201508,2,1566,783,832,0,0,0,0,-1,2,0,0,1.2933036102566092e-6,1,0,0.0013786009963405752,2015-08-01,2,1566,8
Portugal,201508,7,130313,18616.1428571429,115097,2,96115,48057.5,92947,-0.15103255781087144,9,0,17,0.0028351960761698026,1,0.08461317673261455,0.11471879414823076,2015-08-01,5,226428,8
Brazil,201508,1,70090,70090,70090,0,0,0,0,-1,1,0,0,7.530289923924975e-18,3,0,0.061702518412203644,2015-08-01,1,70090,8
Saint Vincent and the Grenadines,201508,1,58,58,58,0,0,0,0,-1,1,0,0,6.432875672344976e-13,1,0,5.105929616076204e-5,2015-08-01,1,58,8
United States of America,201508,8,765407,95675.875,758845,0,0,0,0,-1,8,0,6,1.253988805062584e-5,1,0,0.6738128051124206,2015-08-01,8,765407,8
Canada,201508,3,17289,5763,13823,6,1048965,174827.5,758845,0.9675705788676995,9,14,4,3.5477058304241675e-6,1,0.9234381827116165,0.015220071919369223,2015-08-01,-3,1066254,8
Dominican Rep.,201508,3,3763,1254.33333333333,3058,0,0,0,0,-1,3,0,0,1.3184630142396393e-7,1,0,0.0033126919216025443,2015-08-01,3,3763,8
Mexico,201508,1,271613,271613,271613,0,0,0,0,-1,1,0,0,2.3092887533736286e-8,1,0,0.2391098035881562,2015-08-01,1,271613,8
Russian Federation,201508,3,36659,12219.6666666667,30017,4,643435,160858.75,526202,0.8921943143153741,7,131,1,3.0983923868330764e-6,1,0.5664368659517228,0.03227211617167889,2015-08-01,-1,680094,8
Ukraine,201508,2,55604,27802,39500,0,0,0,0,-1,2,0,1,1.5881916818160537e-5,1,0,0.048950019029707116,2015-08-01,2,55604,8
Austria,201508,10,2898090,289809,1819755,12,2203874,183656.166666667,548039,-0.13606838464559923,22,116,70,0.05083682166173476,1,1.9401423321897118,2.5512833725955666,2015-08-01,-2,5101964,8
Bulgaria,201508,5,921400,184280,518382,5,165402,33080.4,133445,-0.6956170489196745,10,73,11,0.01163772471148618,1,0.14560878799279936,0.8111385428021749,2015-08-01,0,1086802,8
Greece,201508,6,323148,53858,287687,8,172135,21516.875,63528,-0.3049024497105695,14,110,32,0.0011951707132159958,1,0.1515360680109099,0.28447774889237815,2015-08-01,-2,495283,8
Hungary,201508,8,3427197,428399.625,1422359,4,676973,169243.25,404728,-0.6701047958539729,12,0,26,0.03741012698908854,1,0.5959614637903373,3.017073562487503,2015-08-01,4,4104170,8
Slovakia,201508,4,291942,72985.5,239830,12,957181,79765.0833333333,252882,0.532564847497004,16,14,51,0.008764228866049101,1,0.842637726869903,0.2570060868925033,2015-08-01,-8,1249123,8
TFYR of Macedonia,201508,8,495902,61987.75,196347,0,0,0,0,-1,8,0,15,0.0022523076875214554,1,0,0.4365587428399003,2015-08-01,8,495902,8
Latvia,201508,2,51047,25523.5,32446,6,210254,35042.3333333333,122871,0.6092858427637093,8,0,8,1.9674872574053164e-4,1,0.18509346991353212,0.04493834295031759,2015-08-01,-4,261301,8
Armenia,201508,2,83394,41697,83181,0,0,0,0,-1,2,0,0,6.176474330668999e-9,1,0,0.07341446455225155,2015-08-01,2,83394,8
Bosnia Herzegovina,201508,4,3034163,758540.75,1368608,1,81903,81903,81903,-0.9474317938066781,5,0,8,0.029851049175521564,1,0.07210188850784299,2.6710728830521764,2015-08-01,3,3116066,8
Costa Rica,201508,1,421,421,421,0,0,0,0,-1,1,0,0,8.958829616152414e-6,1,0,3.706200635117383e-4,2015-08-01,1,421,8
Jordan,201508,3,115442,38480.6666666667,83463,0,0,0,0,-1,3,0,1,2.927747307668993e-4,1,0,0.10162736667914986,2015-08-01,3,115442,8
Luxembourg,201508,2,814,407,602,8,220563,27570.375,140562,0.9926460291719555,10,342,19,0.0017820825502810021,1,0.19416881963976135,7.165908116355225e-4,2015-08-01,-6,221377,8
Peru,201508,2,9949,4974.5,6438,0,0,0,0,-1,2,0,0,7.47136615939717e-5,1,0,0.008758429956955544,2015-08-01,2,9949,8
Czech Rep.,201508,8,589004,73625.5,407730,16,5184986,324061.625,1534811,0.7959802493596283,24,478,87,0.07150317305965148,1,4.564512685575947,0.5185194771702325,2015-08-01,-8,5773990,8
Thailand,201508,6,335194,55865.6666666667,264450,0,0,0,0,-1,6,0,5,3.5045213788836204e-5,1,0,0.295082236505353,2015-08-01,6,335194,8
Turkey,201508,12,477438,39786.5,133445,0,0,0,0,-1,12,0,31,0.002804300837015073,1,0,0.42030428000692943,2015-08-01,12,477438,8
Albania,201508,1,1037,1037,1037,0,0,0,0,-1,1,0,0,2.9702211430929816e-8,1,0,9.129050020467282e-4,2015-08-01,1,1037,8
Malaysia,201508,2,858893,429446.5,855477,9,275389,30598.7777777778,264450,-0.5144258658781502,11,48,17,2.8898828106518908e-5,1,0.2424339398347603,0.7561115871966447,2015-08-01,-7,1134282,8
New Zealand,201508,1,907,907,907,0,0,0,0,-1,1,0,0,1.4618498916478356e-9,1,0,7.984617520312271e-4,2015-08-01,1,907,8
Rep. of Korea,201508,2,4972,2486,4838,0,0,0,0,-1,2,0,1,8.505013081451373e-9,1,0,0.0043770141467467044,2015-08-01,2,4972,8
Japan,201508,3,57843,19281,51583,0,0,0,0,-1,3,0,3,1.0911802373602256e-7,1,0,0.05092108392805101,2015-08-01,3,57843,8
China,201508,5,273405,54681,264771,0,0,0,0,-1,5,0,4,4.310421205432381e-7,1,0,0.24068735977298528,2015-08-01,5,273405,8
Estonia,201508,4,16512,4128,12412,7,213401,30485.8571428571,146868,0.8563630590701701,11,140,26,0.0031641357830696298,1,0.18786387689659967,0.014536053417353497,2015-08-01,-3,229913,8
Serbia,201508,8,488126,61015.75,277951,0,0,0,0,-1,8,0,9,4.1855054388516776e-4,1,0,0.4297132758235885,2015-08-01,8,488126,8
Sweden,201508,3,110284,36761.3333333333,83945,9,2163744,240416,1849621,0.9030055918396783,12,0,41,0.04719799990662921,1,1.904814581242619,0.09708661065161174,2015-08-01,-6,2274028,8
Ghana,201508,1,3208,3208,3208,0,0,0,0,-1,1,0,0,2.8010303843411827e-5,1,0,0.002824107277305597,2015-08-01,1,3208,8
Ireland,201508,2,26094,13047,13496,9,980965,108996.111111111,762981,0.9481778128193085,11,159,26,0.021427678076955017,1,0.863575559626585,0.022971401276188356,2015-08-01,-7,1007059,8
Norway,201508,1,43357,43357,43357,7,872948,124706.857142857,822832,0.9053655715073038,8,0,17,0.019892499439284186,1,0.7684846631887052,0.03816858454555448,2015-08-01,-6,916305,8
Iran,201508,1,1795,1795,1795,0,0,0,0,-1,1,0,0,1.2431535424629398e-9,1,0,0.0015801971829063424,2015-08-01,1,1795,8
Slovenia,201508,3,536176,178725.333333333,535764,10,337035,33703.5,135177,-0.22805599104912788,13,259,16,0.0010286918623618,1,0.2967029289921109,0.47201326169470254,2015-08-01,-7,873211,8
Uganda,201508,1,756,756,756,0,0,0,0,-1,1,0,0,6.741812779815923e-6,1,0,6.655315154747604e-4,2015-08-01,1,756,8
Finland,201508,1,12,12,12,8,836485,104560.625,597924,0.9999713089228055,9,83,21,0.014867565001983817,1,0.736385092224742,1.056399230912318e-5,2015-08-01,-7,836497,8
Suriname,201508,1,579,579,579,0,0,0,0,-1,1,0,0,1.3875819759192929e-5,1,0,5.097126289151935e-4,2015-08-01,1,579,8
Afghanistan,201508,1,58375,58375,58375,0,0,0,0,-1,1,0,0,9.421647743150797e-14,1,0,0.05138942092042214,2015-08-01,1,58375,8
Belarus,201508,2,589913,294956.5,526202,3,228300,76100,188600,-0.44195460106353723,5,215,1,2.452482575956598e-4,1,0.20097995368106852,0.5193196995876486,2015-08-01,-1,818213,8
Croatia,201508,2,5413,2706.5,4980,12,1367999,113999.916666667,982339,0.9921174418164397,14,101,38,0.0023531782445820426,1,1.2042942429073502,0.004765240864106982,2015-08-01,-10,1373412,8
Dominica,201508,1,82,82,82,0,0,0,0,-1,1,0,0,3.3886304657662386e-16,1,0,7.21872807790084e-5,2015-08-01,1,82,8
Zambia,201508,1,154,154,154,0,0,0,0,-1,1,0,0,5.02019328261665e-18,1,0,1.3557123463374748e-4,2015-08-01,1,154,8
"China, Hong Kong SAR",201508,1,279,279,279,10,346869,34686.9,264771,0.9983926164056829,11,9,16,6.725357963388482e-5,1,0.3053601206894374,2.4561282118711395e-4,2015-08-01,-9,347148,8
Indonesia,201508,1,4,4,4,0,0,0,0,-1,1,0,0,2.1116599650855457e-11,1,0,3.521330769707727e-6,2015-08-01,1,4,8
Viet Nam,201508,1,817,817,817,0,0,0,0,-1,1,0,0,2.510096641308325e-18,4,0,7.192318097128033e-4,2015-08-01,1,817,8
Bangladesh,201508,1,15465,15465,15465,0,0,0,0,-1,1,0,0,2.2140734643108432e-10,1,0,0.0136143450883825,2015-08-01,1,15465,8
Pakistan,201508,1,4704,4704,4704,1,58375,58375,58375,0.8508536914028441,2,1,0,6.734577742185686e-11,1,0.05138942092042214,0.004141084985176287,2015-08-01,0,63079,8
Saudi Arabia,201508,1,12566,12566,12566,0,0,0,0,-1,1,0,0,1.7990331263299698e-10,1,0,0.011062260613036824,2015-08-01,1,12566,8
Seychelles,201508,0,0,0,0,7,11824,1689.14285714286,4537,1,7,0,2,8.573121269195188e-5,1,0.010409053755256041,0,2015-08-01,-7,11824,8
Rep. of Moldova,201508,0,0,0,0,1,173,173,173,1,1,0,0,3.383918401906923e-8,1,1.522975557898592e-4,0,2015-08-01,-1,173,8
El Salvador,201508,0,0,0,0,2,29104,14552,14790,1,2,0,0,1.00403865652333e-17,2,0.02562120268039342,0,2015-08-01,-2,29104,8
Paraguay,201508,0,0,0,0,1,70090,70090,70090,1,1,0,0,7.530289923924975e-18,3,0.061702518412203644,0,2015-08-01,-1,70090,8
Barbados,201508,0,0,0,0,3,237,79,126,1,3,0,0,4.628016136197821e-7,1,2.0863884810518282e-4,0,2015-08-01,-3,237,8
Georgia,201508,0,0,0,0,1,213,213,213,1,1,0,0,3.153434410475649e-14,1,1.8751086348693647e-4,0,2015-08-01,-1,213,8
Iceland,201508,0,0,0,0,1,1344,1344,1344,1,1,0,0,3.2209156746728034e-5,1,0.0011831671386217963,0,2015-08-01,-1,1344,8
Madagascar,201508,0,0,0,0,1,327,327,327,1,1,0,0,4.419465367385929e-7,1,2.8786879042360666e-4,0,2015-08-01,-1,327,8
Montenegro,201508,0,0,0,0,1,29921,29921,29921,1,1,0,0,3.0012633228854046e-7,1,0.026340434490106226,0,2015-08-01,-1,29921,8
Cabo Verde,201508,0,0,0,0,2,118,59,95,1,2,0,0,1.1078656388591842e-8,1,1.0387925770637795e-4,0,2015-08-01,-2,118,8
Cyprus,201508,0,0,0,0,1,5278,5278,5278,1,1,0,0,1.511748041408541e-7,1,0.004646395950629345,0,2015-08-01,-1,5278,8
Malta,201508,0,0,0,0,2,58135,29067.5,33306,1,2,0,1,6.017262797080162e-4,1,0.05117814107423968,0,2015-08-01,-2,58135,8
Chile,201508,0,0,0,0,1,6438,6438,6438,1,1,0,0,1.1527392469713563e-8,1,0.005667581873844587,0,2015-08-01,-1,6438,8
Switzerland,201508,0,0,0,0,11,402531,36593.7272727273,130075,1,11,0,22,0.0018704380995152206,1,0.3543611990153053,0,2015-08-01,-11,402531,8
Antigua and Barbuda,201508,0,0,0,0,2,648,324,566,1,2,0,0,1.7009446993244117e-10,1,5.704555846926518e-4,0,2015-08-01,-2,648,8
Mozambique,201508,0,0,0,0,2,10115,5057.5,9961,1,2,0,0,1.9633975928313718e-14,1,0.008904565183898415,0,2015-08-01,-2,10115,8
Singapore,201508,0,0,0,0,13,976341,75103.1538461538,855477,1,13,0,18,2.2028441101405786e-4,1,0.859504901256803,0,2015-08-01,-13,976341,8
Ethiopia,201508,0,0,0,0,1,817,817,817,1,1,0,0,2.510096641308325e-18,4,7.192318097128033e-4,0,2015-08-01,-1,817,8
Bermuda,201508,0,0,0,0,1,3059,3059,3059,1,1,0,0,9.192914584288383e-10,1,0.002692937706133984,0,2015-08-01,-1,3059,8
Greenland,201508,0,0,0,0,2,25767,12883.5,25416,1,2,0,1,1.7447275373711536e-5,1,0.02268353248576475,0,2015-08-01,-2,25767,8
Kuwait,201508,0,0,0,0,7,309652,44236,179863,1,7,0,0,5.973955866492954e-7,1,0.27259677887538425,0,2015-08-01,-7,309652,8
Botswana,201508,0,0,0,0,2,64225,32112.5,64111,1,2,0,0,5.8622955644226146e-12,1,0.056539367171119695,0,2015-08-01,-2,64225,8
Kazakhstan,201508,0,0,0,0,2,7729,3864.5,6442,1,2,0,1,4.916352793450769e-10,1,0.006804091379767755,0,2015-08-01,-2,7729,8
Senegal,201508,0,0,0,0,1,121,121,121,1,1,0,0,3.530356117416031e-7,1,1.0652025578365874e-4,0,2015-08-01,-1,121,8
Netherlands,201509,33,55722365,1688556.51515152,30730347,8,4169275,521159.375,2065214,-0.8607727222029652,41,216,143,0.9999999999999999,1,3.892529442042971,52.023660310908916,2015-09-01,25,59891640,9
Spain,201509,28,14703085,525110.178571429,7281060,10,246974,24697.4,65935,-0.9669601303914587,38,444,133,0.2602920544137468,1,0.2305805125397391,13.727132715246746,2015-09-01,18,14950059,9
Bulgaria,201509,6,1034037,172339.5,669794,6,294180,49030,166553,-0.5570302141893982,12,205,14,0.010268599308626525,2,0.2746531018606835,0.965400331391378,2015-09-01,0,1328217,9
Estonia,201509,5,78197,15639.4,55870,6,145707,24284.5,59203,0.30151314849221095,11,83,20,0.001026457357260618,1,0.13603535084918963,0.07300648788564779,2015-09-01,-1,223904,9
Lithuania,201509,6,179960,29993.3333333333,90493,5,236347,47269.4,113108,0.1354457167426923,11,0,25,5.601777977076503e-4,1,0.22065890497473303,0.16801472639488954,2015-09-01,1,416307,9
Poland,201509,16,1387402,86712.625,605362,10,1017380,101738,418005,-0.15386924885498976,26,922,98,0.03033228689122119,1,0.9498489794378345,1.2953098879179958,2015-09-01,6,2404782,9
Latvia,201509,2,69276,34638,53663,5,140753,28150.6,90493,0.34031967014079006,7,0,6,4.992025671893579e-4,1,0.1314101843979767,0.06467764050751482,2015-09-01,-3,210029,9
Australia,201509,4,42922,10730.5,20825,0,0,0,0,-1,4,0,2,3.3566545454966087e-7,3,0,0.040072950024013385,2015-09-01,4,42922,9
China,201509,5,475039,95007.8,312696,0,0,0,0,-1,5,0,3,2.255219353861839e-6,4,0,0.4435071549894528,2015-09-01,5,475039,9
Japan,201509,4,41751,10437.75,35560,1,2320,2320,2320,-0.8947153456921785,5,44,4,5.359945162274192e-7,3,0.0021660044745284712,0.0389796779379475,2015-09-01,3,44071,9
India,201509,7,1032037,147433.857142857,914588,0,0,0,0,-1,7,0,2,1.944156479236878e-6,5,0,0.9635330861547156,2015-09-01,7,1032037,9
Thailand,201509,5,311866,62373.2,237165,0,0,0,0,-1,5,0,2,6.890962486178719e-7,4,0,0.29116515148848976,2015-09-01,5,311866,9
United States of America,201509,7,986639,140948.428571429,979738,0,0,0,0,-1,7,0,3,1.0849014781062197e-5,3,0,0.921148486527714,2015-09-01,7,986639,9
Serbia,201509,9,163386,18154,48260,2,286967,143483.5,286856,0.2744091856832307,11,95,25,9.267740421919697e-5,2,0.2679188819146603,0.1525408651186676,2015-09-01,7,450353,9
TFYR of Macedonia,201509,14,1779998,127142.714285714,590898,0,0,0,0,-1,14,0,40,0.006151245352854809,2,0,1.6618463933843663,2015-09-01,14,1779998,9
Albania,201509,3,30197,10065.6666666667,15878,0,0,0,0,-1,3,0,1,5.656809562757751e-6,2,0,0.028192602205748384,2015-09-01,3,30197,9
Belarus,201509,2,674379,337189.5,670178,3,58800,19600,57200,-0.8396026072759858,5,427,2,1.3683159974306818e-5,4,0.054897009957876775,0.6296154877276017,2015-09-01,-1,733179,9
Czech Rep.,201509,8,1574083,196760.375,1424046,16,3805897,237868.5625,746211,0.41483685812958415,24,1016,95,0.07778806580738609,1,3.5532715222390023,1.4695994919306896,2015-09-01,-8,5379980,9
France,201509,13,457245,35172.6923076923,252310,15,3891680,259445.333333333,1795623,0.7897204481567284,28,999,88,0.06877712621449733,1,3.633360471307311,0.42689427411886677,2015-09-01,-2,4348925,9
Germany,201509,22,4127850,187629.545454545,746211,19,46101308,2426384.63157895,30730347,0.8356392914251121,41,673,153,0.9457096367363186,1,43.04122388345483,3.8538541250785996,2015-09-01,3,50229158,9
Hungary,201509,10,836377,83637.7,468129,6,358313,59718.8333333333,149054,-0.40015736299793253,16,0,55,0.017609477122431348,1,0.33452912124212075,0.7808604846520255,2015-09-01,4,1194690,9
Romania,201509,9,1065622,118402.444444444,615696,7,85853,12264.7142857143,47207,-0.8508816952170043,16,400,37,0.01700524603300083,2,0.08015430265159175,0.9948888017913702,2015-09-01,2,1151475,9
Ukraine,201509,2,119936,59968,62736,0,0,0,0,-1,2,0,1,5.262079065097858e-5,4,0,0.11197496235217531,2015-09-01,2,119936,9
Bosnia Herzegovina,201509,4,788502,197125.5,379539,3,26052,8684,14007,-0.9360337067892368,7,0,19,0.01000936570286295,2,0.024322736452765403,0.7361633017994176,2015-09-01,1,814554,9
Austria,201509,9,590178,65575.3333333333,301943,13,2177010,167462.307692308,615562,0.5734456784287877,22,129,86,0.028279765462548286,2,2.032505776333288,0.5510035296414931,2015-09-01,-4,2767188,9
Canada,201509,3,29225,9741.66666666667,27155,8,1463120,182890,979738,0.9608334533904693,11,165,7,3.999852286983872e-4,5,1.3660019253328004,0.02728512102073042,2015-09-01,-5,1492345,9
Croatia,201509,1,16689,16689,16689,12,508046,42337.1666666667,286508,0.9363907496164731,13,0,45,8.093254958314585e-4,2,0.474323236752712,0.015581227877330026,2015-09-01,-11,524735,9
Italy,201509,16,347361,21710.0625,148645,9,982814,109201.555555556,311641,0.4777213524536245,25,1313,94,0.013296051789636346,1,0.917577380012597,0.32430408632615704,2015-09-01,7,1330175,9
Turkey,201509,12,1151135,95927.9166666667,795344,0,0,0,0,-1,12,0,26,0.021712003140467267,1,0,1.0747256727527292,2015-09-01,12,1151135,9
Luxembourg,201509,2,832,416,830,9,174301,19366.7777777778,101320,0.9904986495977343,11,433,21,0.0015860623539229884,1,0.16273135599775307,7.767740184515897e-4,2015-09-01,-7,175133,9
Uganda,201509,1,154,154,154,0,0,0,0,-1,1,0,0,1.295346365547622e-6,1,0,1.437778832230106e-4,2015-09-01,1,154,9
Peru,201509,1,650,650,650,0,0,0,0,-1,1,0,0,5.122252861008061e-18,6,0,6.068547019153045e-4,2015-09-01,1,650,9
Denmark,201509,6,81105,13517.5,55431,21,1888889,89947.0952380952,1242262,0.9176596476943585,27,451,122,0.04131580820783119,1,1.7635094939170732,0.07572146245975503,2015-09-01,-15,1969994,9
United Kingdom,201509,8,77731,9716.375,30702,13,12772477,982498.230769231,11369234,0.9879019857110484,21,139,60,0.3245779959061018,1,11.92467341931551,0.07257141974550543,2015-09-01,-5,12850208,9
Belgium,201509,11,5587997,507999.727272727,3029389,8,6323052,790381.5,5743813,0.06171202889015065,19,278,50,0.30430451080027965,1,5.903344364084569,5.2170803903671015,2015-09-01,3,11911049,9
Slovenia,201509,3,125740,41913.3333333333,123622,13,167023,12847.9230769231,38588,0.14101167155685657,16,821,36,2.204810253665974e-4,2,0.15593645058153832,0.11739370802896983,2015-09-01,-10,292763,9
Greece,201509,8,160048,20006,62063,4,107402,26850.5,79078,-0.1968442699570013,12,135,22,0.0040420995990094,2,0.10027293645401159,0.14942443281867793,2015-09-01,4,267450,9
Slovakia,201509,4,133013,33253.25,107235,11,812576,73870.5454545455,331901,0.7186663550443163,15,0,53,0.009801741785564932,2,0.7586393327131238,0.12418394533209291,2015-09-01,-7,945589,9
Afghanistan,201509,1,77546,77546,77546,0,0,0,0,-1,1,0,0,2.708913670049835e-12,7,0,0.07239869956111415,2015-09-01,1,77546,9
Suriname,201509,1,269,269,269,0,0,0,0,-1,1,0,0,7.435481201794432e-6,1,0,2.511444843311029e-4,2015-09-01,1,269,9
Morocco,201509,4,1757,439.25,897,0,0,0,0,-1,4,0,3,2.2477714030645884e-6,5,0,0.0016403749404079846,2015-09-01,4,1757,9
Portugal,201509,6,12224,2037.33333333333,7395,3,57586,19195.3333333333,39063,0.6497922933677124,9,4,19,0.0012396955835010397,1,0.05376359209922265,0.01141260288648105,2015-09-01,3,69810,9
Kazakhstan,201509,1,8899,8899,8899,3,2371,790.333333333333,1888,-0.5792369121561668,4,87,1,1.8708648503669655e-10,4,0.0022136192280633646,0.008308307680529684,2015-09-01,-2,11270,9
Azerbaijan,201509,1,616603,616603,616603,0,0,0,0,-1,1,0,0,4.654996829052226e-9,4,0,0.5756745073308961,2015-09-01,1,616603,9
Dominican Rep.,201509,4,10412,2603,5673,0,0,0,0,-1,4,0,1,1.1248398122443397e-5,5,0,0.009720878702064846,2015-09-01,4,10412,9
Iran,201509,1,266,266,266,0,0,0,0,-1,1,0,0,1.4087351849278002e-7,5,0,2.483436164761092e-4,2015-09-01,1,266,9
Dominica,201509,1,254,254,254,0,0,0,0,-1,1,0,0,1.8132775127968537e-15,3,0,2.3714014505613436e-4,2015-09-01,1,254,9
South Africa,201509,4,72773,18193.25,56509,0,0,0,0,-1,4,0,0,5.850336152309248e-9,4,0,0.06794251880381916,2015-09-01,4,72773,9
Malaysia,201509,2,798489,399244.5,791735,7,317449,45349.8571428571,237165,-0.43106337448854687,9,5,12,2.2052622698446983e-5,3,0.29637756656663305,0.7454873908886916,2015-09-01,-5,1115938,9
Rep. of Korea,201509,3,7591,2530.33333333333,5128,0,0,0,0,-1,3,0,2,7.319612272375288e-8,3,0,0.007087129295752425,2015-09-01,3,7591,9
Nepal,201509,1,20,20,20,0,0,0,0,-1,1,0,0,1.3481721380996323e-10,4,0,1.8672452366624753e-5,2015-09-01,1,20,9
Egypt,201509,3,2013,671,1052,0,0,0,0,-1,3,0,1,2.3766047624651455e-5,1,0,0.0018793823307007814,2015-09-01,3,2013,9
Jordan,201509,6,197555,32925.8333333333,105218,0,0,0,0,-1,6,0,10,7.205167421108764e-4,7,0,0.18444181636442766,2015-09-01,6,197555,9
Lebanon,201509,4,4666,1166.5,2990,0,0,0,0,-1,4,0,2,1.1838790359403505e-5,7,0,0.004356283137133555,2015-09-01,4,4666,9
Pakistan,201509,1,1139,1139,1139,1,77546,77546,77546,0.9710491199084959,2,1,0,1.2638003456737005e-9,7,0.07239869956111415,0.0010633961622792797,2015-09-01,0,78685,9
Saudi Arabia,201509,1,59380,59380,59380,0,0,0,0,-1,1,0,0,6.588596945655002e-8,7,0,0.05543851107650889,2015-09-01,1,59380,9
United Arab Emirates,201509,1,3554,3554,3554,0,0,0,0,-1,1,0,0,6.803224749118036e-9,1,0,0.0033180947855492187,2015-09-01,1,3554,9
Mexico,201509,1,435357,435357,435357,0,0,0,0,-1,1,0,0,4.813337174024832e-6,5,0,0.4064591422488326,2015-09-01,1,435357,9
Brazil,201509,1,29163,29163,29163,0,0,0,0,-1,1,0,0,2.5611264305040305e-18,8,0,0.027227236418393884,2015-09-01,1,29163,9
Russian Federation,201509,2,493,246.5,293,5,1608420,321684,670178,0.9993871638802098,7,305,1,2.731221707198825e-7,4,1.5016572917763293,4.602759508373002e-4,2015-09-01,-3,1608913,9
Uzbekistan,201509,1,190,190,190,0,0,0,0,-1,1,0,0,9.885948021745557e-16,4,0,1.7738829748293515e-4,2015-09-01,1,190,9
Ghana,201509,1,2882,2882,2882,0,0,0,0,-1,1,0,0,2.5856506758170076e-5,1,0,0.002690700386030627,2015-09-01,1,2882,9
Ireland,201509,1,27185,27185,27185,9,696785,77420.5555555556,496216,0.9249002030470875,10,0,26,0.017259673900793644,1,0.6505342361139315,0.025380530879334697,2015-09-01,-8,723970,9
Sweden,201509,4,115359,28839.75,55824,9,2103642,233738,1565098,0.8960261847561132,13,0,46,0.04757077751632197,1,1.9640077520715615,0.10770177162807325,2015-09-01,-5,2219001,9
Armenia,201509,1,3018,3018,3018,0,0,0,0,-1,1,0,0,5.122252861008061e-18,9,0,0.0028176730621236753,2015-09-01,1,3018,9
Finland,201509,1,4,4,4,9,918912,102101.333333333,665475,0.999991294089993,10,106,27,0.021130351685180754,1,0.8579170274559943,3.7344904733249507e-6,2015-09-01,-8,918916,9
Guatemala,201509,1,14917,14917,14917,0,0,0,0,-1,1,0,0,5.122252861008061e-18,10,0,0.013926848597647073,2015-09-01,1,14917,9
Honduras,201509,1,8788,8788,8788,0,0,0,0,-1,1,0,0,2.5611264305040305e-18,10,0,0.008204675569894916,2015-09-01,1,8788,9
New Zealand,201509,1,848,848,848,0,0,0,0,-1,1,0,0,1.1939107038839494e-8,3,0,7.917119803448895e-4,2015-09-01,1,848,9
Saint Vincent and the Grenadines,201509,1,60,60,60,1,337,337,337,0.6977329974811083,2,0,1,1.0236903274319814e-10,3,3.146308223776271e-4,5.601735709987426e-5,2015-09-01,0,397,9
Norway,201509,1,43203,43203,43203,7,860192,122884.571428571,750790,0.9043541308065686,8,0,21,0.02144793864229019,1,0.803094707307584,0.04033529797976446,2015-09-01,-6,903395,9
Iceland,201509,0,0,0,0,2,3780,1890,3700,1,2,0,1,1.0284800067220985e-4,1,0.0035290934972920782,0,2015-09-01,-2,3780,9
Montenegro,201509,0,0,0,0,3,37016,12338.6666666667,31619,1,3,0,1,3.147364157533468e-7,2,0.034558974840149095,0,2015-09-01,-3,37016,9
Chile,201509,0,0,0,0,1,650,650,650,1,1,0,0,2.5611264305040305e-18,6,6.068547019153045e-4,0,2015-09-01,-1,650,9
Cyprus,201509,0,0,0,0,1,1873,1873,1873,1,1,0,0,2.0926740449906996e-7,2,0.0017486751641344082,0,2015-09-01,-1,1873,9
Malta,201509,0,0,0,0,3,24439,8146.33333333333,19311,1,3,0,3,1.2129988222760467e-4,1,0.022816803169397118,0,2015-09-01,-3,24439,9
Switzerland,201509,0,0,0,0,13,1142751,87903.9230769231,604010,1,13,0,29,0.019159797960853847,5,1.0668981807206401,0,2015-09-01,-13,1142751,9
Antigua and Barbuda,201509,0,0,0,0,2,1115,557.5,861,1,2,0,0,2.58196452348054e-10,3,0.00104098921943933,0,2015-09-01,-2,1115,9
Mozambique,201509,0,0,0,0,1,14350,14350,14350,1,1,0,0,2.3205444581282037e-12,4,0.01339748457305326,0,2015-09-01,-1,14350,9
Singapore,201509,0,0,0,0,11,920382,83671.0909090909,791735,1,11,0,8,2.4387009026034012e-4,4,0.8592894527049412,0,2015-09-01,-11,920382,9
Bermuda,201509,0,0,0,0,1,3520,3520,3520,1,1,0,0,1.055576628093411e-9,3,0.0032863516165259564,0,2015-09-01,-1,3520,9
Greenland,201509,0,0,0,0,3,19183,6394.33333333333,16766,1,3,0,3,2.0969906401465848e-5,1,0.017909682687448133,0,2015-09-01,-3,19183,9
Rep. of Moldova,201509,0,0,0,0,1,185,185,185,1,1,0,0,8.69583815395522e-8,2,1.7272018439127898e-4,0,2015-09-01,-1,185,9
Kuwait,201509,0,0,0,0,8,1089126,136140.75,914588,1,8,0,1,4.0141717229198525e-5,7,1.0168326678126276,0,2015-09-01,-8,1089126,9
Seychelles,201509,0,0,0,0,7,11971,1710.14285714286,3554,1,7,0,2,6.925331946982461e-5,1,0.011176396364043247,0,2015-09-01,-7,11971,9
Algeria,201509,0,0,0,0,1,19286,19286,19286,1,1,0,0,1.0364066274946056e-9,5,0.01800584581713625,0,2015-09-01,-1,19286,9
Botswana,201509,0,0,0,0,1,56509,56509,56509,1,1,0,0,9.13808885953266e-12,4,0.05275808053927991,0,2015-09-01,-1,56509,9
Paraguay,201509,0,0,0,0,1,29163,29163,29163,1,1,0,0,2.5611264305040305e-18,8,0.027227236418393884,0,2015-09-01,-1,29163,9
Georgia,201509,0,0,0,0,1,3018,3018,3018,1,1,0,0,-0,9,0.0028176730621236753,0,2015-09-01,-1,3018,9
El Salvador,201509,0,0,0,0,2,23705,11852.5,14917,1,2,0,0,5.122252861008061e-18,10,0.02213152416754199,0,2015-09-01,-2,23705,9
"China, Hong Kong SAR",201509,0,0,0,0,10,250607,25060.7,159908,1,10,0,9,5.093533812310592e-4,3,0.2339723635121365,0,2015-09-01,-10,250607,9
Barbados,201509,0,0,0,0,3,501,167,353,1,3,0,1,7.896175144699304e-7,3,4.6774493178395005e-4,0,2015-09-01,-3,501,9
Australia,201510,4,15477,3869.25,5966,0,0,0,0,-1,4,0,2,2.0007364105047036e-8,1,0,0.014945463095370414,2015-10-01,4,15477,10
Canada,201510,4,40191,10047.75,34630,11,3789559,344505.363636364,1287312,0.9790111626085254,15,179,9,0.04073440728999719,2,3.6594116548574536,0.038810693756285604,2015-10-01,-7,3829750,10
Malaysia,201510,3,876383,292127.666666667,871982,7,250581,35797.2857142857,243979,-0.555299015762704,10,12,12,3.2713978744806566e-5,1,0.24197513005757018,0.846284795755638,2015-10-01,-4,1126964,10
Netherlands,201510,33,27762812,841297.333333333,14566874,8,6112638,764079.75,5150191,-0.6391110376393524,41,460,141,0.7804795315964955,3,5.90270760769909,26.809335282658584,2015-10-01,25,33875450,10
New Zealand,201510,1,779,779,779,0,0,0,0,-1,1,0,0,5.778853227266058e-10,1,0,7.522462848932967e-4,2015-10-01,1,779,10
Thailand,201510,5,316863,63372.6,243979,0,0,0,0,-1,5,0,2,5.352692758478445e-7,1,0,0.3059807632479392,2015-10-01,5,316863,10
United States of America,201510,8,1104442,138055.25,1088240,0,0,0,0,-1,8,0,4,0.0015083630468260383,2,0,1.0665114138384113,2015-10-01,8,1104442,10
China,201510,6,2136439,356073.166666667,1936225,0,0,0,0,-1,6,0,4,3.8732212350822596e-5,4,0,2.0630658544944156,2015-10-01,6,2136439,10
Japan,201510,4,46252,11563,39951,0,0,0,0,-1,4,0,2,3.9726817213151156e-8,1,0,0.044663536802162715,2015-10-01,4,46252,10
Rep. of Korea,201510,2,5292,2646,5071,0,0,0,0,-1,2,0,0,4.124067630070828e-9,1,0,0.005110253324332896,2015-10-01,2,5292,10
Brazil,201510,2,4211,2105.5,2795,0,0,0,0,-1,2,0,0,7.165178311223146e-6,5,0,0.004066378826297397,2015-10-01,2,4211,10
Guatemala,201510,1,18731,18731,18731,0,0,0,0,-1,1,0,0,1.4457781639738762e-13,2,0,0.0180877088091609,2015-10-01,1,18731,10
Honduras,201510,2,4642,2321,3081,0,0,0,0,-1,2,0,0,4.270438158712606e-6,2,0,0.0044825767066427255,2015-10-01,2,4642,10
Albania,201510,14,374377,26741.2142857143,161739,0,0,0,0,-1,14,0,45,7.896324932308043e-5,6,0,0.36151952169383533,2015-10-01,14,374377,10
Serbia,201510,6,30675,5112.5,17254,4,380969,95242.25,271057,0.8509634538581882,10,166,22,5.271984086487666e-5,6,0.3678851282535486,0.02962150807330151,2015-10-01,2,411644,10
TFYR of Macedonia,201510,19,1167644,61454.9473684211,271057,1,5145,5145,5145,-0.9912260432183453,20,2,60,0.005393972736140876,6,0.004968301843101427,1.1275428255172637,2015-10-01,18,1172789,10
Armenia,201510,1,4713,4713,4713,0,0,0,0,-1,1,0,0,4.410488124598843e-9,7,0,0.00455113830642119,2015-10-01,1,4713,10
Turkey,201510,18,2305611,128089.5,1482110,0,0,0,0,-1,18,0,51,0.007129830451056356,7,0,2.2264278679834644,2015-10-01,18,2305611,10
Austria,201510,8,407768,50971,216555,11,3115184,283198.545454545,1033508,0.7685077741621231,19,204,78,0.07234699946415629,6,3.0081971640039016,0.39376375237274686,2015-10-01,-3,3522952,10
Bulgaria,201510,6,341224,56870.6666666667,267676,4,326961,81740.25,161739,-0.0213458847474876,10,0,23,0.001969242178160387,6,0.3157319609178398,0.3295051172226319,2015-10-01,2,668185,10
Portugal,201510,8,33999,4249.875,20028,2,73830,36915,54566,0.36939042372645575,10,24,21,0.0026736678564307772,6,0.0712944072062543,0.03283134973053555,2015-10-01,6,107829,10
Spain,201510,32,45755857,1429870.53125,19058065,12,156628,13052.3333333333,36188,-0.9931771064014505,44,205,144,0.8738596714808868,6,0.15124882042396312,44.18443317119248,2015-10-01,20,45912485,10
Estonia,201510,4,70635,17658.75,55804,5,34914,6982.8,18345,-0.3384304919989768,9,503,15,6.18812304910349e-4,6,0.03371492527697633,0.06820913521622338,2015-10-01,-1,105549,10
Latvia,201510,2,45870,22935,44362,8,309306,38663.25,193696,0.7417055206432867,10,4,16,0.007625548900822593,6,0.2986832983250398,0.04429465608222788,2015-10-01,-6,355176,10
Poland,201510,13,493158,37935.2307692308,193903,12,2767233,230602.75,2001513,0.6974853629518668,25,386,114,0.08288640725507708,6,2.672196076616344,0.4762211468105371,2015-10-01,1,3260391,10
Israel,201510,1,700,700,700,0,0,0,0,-1,1,0,0,3.0772065058226597e-8,4,0,6.759594344355682e-4,2015-10-01,1,700,10
Kazakhstan,201510,2,84037,42018.5,74237,5,93741,18748.2,58444,0.05458493176883529,7,5,5,1.9287858578300803e-6,4,0.09052159049060658,0.08115086141665978,2015-10-01,-3,177778,10
Kenya,201510,2,16706,8353,16700,0,0,0,0,-1,2,0,0,7.341336721138765e-7,4,0,0.016132254730972292,2015-10-01,2,16706,10
Morocco,201510,4,34132,8533,20998,0,0,0,0,-1,4,0,3,6.271418222321776e-4,6,0,0.03295978202307831,2015-10-01,4,34132,10
Russian Federation,201510,2,225,112.5,125,12,9544999,795416.583333333,3507335,0.9999528560042173,14,66,8,5.736754347474863e-4,4,9.217188751040092,2.172726753542898e-4,2015-10-01,-10,9545224,10
Ukraine,201510,5,178579,35715.8,102807,0,0,0,0,-1,5,0,4,3.040448088395487e-4,4,0,0.17244594263152763,2015-10-01,5,178579,10
Egypt,201510,7,63707,9101,31800,0,0,0,0,-1,7,0,2,1.0904752103323908e-4,8,0,0.061519068127981066,2015-10-01,7,63707,10
Belize,201510,2,17119,8559.5,17069,0,0,0,0,-1,2,0,0,4.0249410521304987e-7,4,0,0.016531070797289275,2015-10-01,2,17119,10
Dominican Rep.,201510,4,6271,1567.75,3322,0,0,0,0,-1,4,0,0,2.860897588649315e-5,9,0,0.006055630876207784,2015-10-01,4,6271,10
Jordan,201510,7,181178,25882.5714285714,55782,0,0,0,0,-1,7,0,10,0.0010664593230601757,2,0,0.17495568344595341,2015-10-01,7,181178,10
Mexico,201510,1,1229106,1229106,1229106,0,0,0,0,-1,1,0,0,0.0017036095906084027,2,0,1.1868939951733766,2015-10-01,1,1229106,10
India,201510,6,240102,40017,199255,0,0,0,0,-1,6,0,2,3.0334281952049938e-6,2,0,0.2318560173240697,2015-10-01,6,240102,10
Romania,201510,8,312973,39121.625,265337,10,521887,52188.7,190253,0.2502383633184007,18,46,64,0.011417022892420869,6,0.5039634876561078,0.3022243601051473,2015-10-01,-2,834860,10
Slovakia,201510,4,30648,7662,16758,11,613065,55733.1818181818,273776,0.9047774396353655,15,0,46,0.015010020340302006,6,0.5920101009603452,0.029595435352258993,2015-10-01,-7,643713,10
United Kingdom,201510,10,146771,14677.1,46592,13,12271192,943937.846153846,7780726,0.9763615014797515,23,641,59,0.33900666763308585,3,11.849754291671815,0.1417303459307754,2015-10-01,-3,12417963,10
Germany,201510,22,5535100,251595.454545455,900373,19,36597620,1926190.52631579,19058065,0.7372540866101216,41,329,153,1,3,35.34072359555406,5.34500437934902,2015-10-01,3,42132720,10
Greece,201510,10,623680,62368,190253,5,113502,22700.4,95854,-0.6920651887864869,15,103,51,0.007373187300423489,6,0.10960392532472267,0.6022605429553931,2015-10-01,5,737182,10
Italy,201510,19,920557,48450.3684210526,630890,9,870033,96670.3333333333,582870,-0.028216397947045387,28,1317,97,0.028116409424040367,6,0.8401528780289725,0.888941698693862,2015-10-01,10,1790590,10
Belgium,201510,7,2245926,320846.571428571,1673251,7,3428835,489833.571428571,2522353,0.20845089335039838,14,577,31,0.16176029640957099,3,3.311076239104117,2.168792669634483,2015-10-01,0,5674761,10
Czech Rep.,201510,3,15608,5202.66666666667,10917,14,3579441,255674.357142857,2008436,0.991316947279439,17,197,66,0.08810999935133446,6,3.456509877079264,0.015071964075243357,2015-10-01,-11,3595049,10
Finland,201510,1,4,4,4,7,895863,127980.428571429,479213,0.9999910701030399,8,85,15,0.02249851483049906,9,0.8650957811596449,3.862625339631819e-6,2015-10-01,-6,895867,10
France,201510,17,694167,40833.3529411765,202533,15,4960576,330705.066666667,3806155,0.7544832718303909,32,245,98,0.14871145035006125,6,4.790211639192362,0.6703267610340502,2015-10-01,2,5654743,10
Hungary,201510,6,7728,1288,5370,9,502025,55780.5555555556,267212,0.9696794329802866,15,247,42,0.015375223449069105,6,0.4847836215321659,0.007462592156168673,2015-10-01,-3,509753,10
Lithuania,201510,7,53632,7661.71428571429,21002,6,696248,116041.333333333,495269,0.8569584466848029,13,466,25,0.016975477685782645,6,0.6723362918669936,0.051790080553783424,2015-10-01,1,749880,10
Sweden,201510,2,25427,12713.5,21206,9,2127141,236349,1814851,0.9763751946512259,11,0,28,0.06168856626775554,6,2.0540871818924415,0.02455374362770456,2015-10-01,-7,2152568,10
Norway,201510,1,52021,52021,52021,5,682752,136550.4,393407,0.858402527038963,6,1,11,0.01905156945210676,9,0.6593037939710759,0.050234408198246705,2015-10-01,-4,734773,10
Denmark,201510,5,27068,5413.6,12785,21,1719980,81903.8095238095,916181,0.9690128719989376,26,642,114,0.049261650345374386,6,1.6609095829149838,0.026138385673288515,2015-10-01,-16,1747048,10
Afghanistan,201510,1,206680,206680,206680,0,0,0,0,-1,1,0,0,1.6463947992622928e-12,8,0,0.19958185129877606,2015-10-01,1,206680,10
Croatia,201510,2,4621,2310.5,3542,11,287394,26126.7272727273,196385,0.9683509408763249,13,89,35,0.001034804912332729,6,0.27752383671453673,0.004462297923609658,2015-10-01,-9,292015,10
Ireland,201510,1,15510,15510,15510,9,682020,75780,251290,0.9555287944604534,10,0,26,0.019305222636133035,6,0.6585969335339232,0.014977329754422376,2015-10-01,-8,697530,10
Lebanon,201510,4,3715,928.75,1754,0,0,0,0,-1,4,0,3,2.5978037076518485e-5,3,0,0.0035874132841830515,2015-10-01,4,3715,10
Uganda,201510,1,107,107,107,1,6,6,6,-0.8938053097345132,2,46,0,5.889455686363126e-7,4,5.793938009447728e-6,1.0332522783515114e-4,2015-10-01,0,113,10
Slovenia,201510,2,2427,1213.5,2318,12,144169,12014.0833333333,46774,0.9668885917760376,14,678,30,0.001419121680783762,6,0.1392177081473449,0.002343647924821606,2015-10-01,-10,146596,10
Guyana,201510,1,111,111,111,0,0,0,0,-1,1,0,0,2.6046563772117734e-12,3,0,1.0718785317478297e-4,2015-10-01,1,111,10
Bosnia Herzegovina,201510,1,16807,16807,16807,6,19575,3262.5,7684,0.07608157880270464,7,1,11,2.06579161688918e-5,6,0.018902722755823213,0.016229786020797995,2015-10-01,-5,36382,10
Costa Rica,201510,1,3121,3121,3121,0,0,0,0,-1,1,0,0,5.562717777549013e-18,10,0,0.0030138134212477265,2015-10-01,1,3121,10
Algeria,201510,1,234,234,234,0,0,0,0,-1,1,0,0,1.1840760661524511e-6,6,0,2.2596358236846138e-4,2015-10-01,1,234,10
Luxembourg,201510,1,899,899,899,9,136527,15169.6666666667,65046,0.9869165951130062,10,223,20,0.002227183743335152,6,0.13183816243597832,8.681250450822513e-4,2015-10-01,-8,137426,10
Suriname,201510,1,584,584,584,0,0,0,0,-1,1,0,0,1.5509353728578685e-5,3,0,5.639432995862455e-4,2015-10-01,1,584,10
Azerbaijan,201510,1,3507335,3507335,3507335,0,0,0,0,-1,1,0,0,6.846408978454095e-5,4,0,3.386880261394391,2015-10-01,1,3507335,10
Belarus,201510,1,391060,391060,391060,12,311900,25991.6666666667,126500,-0.11260953681575055,13,2,11,0.0012919308404701988,4,0.30118821085779107,0.3776295663291047,2015-10-01,-11,702960,10
Iran,201510,3,2032620,677540,2030986,0,0,0,0,-1,3,0,1,4.022277427106013e-5,4,0,1.9628123794606067,2015-10-01,3,2032620,10
Seychelles,201510,1,39292,39292,39292,7,15823,2260.42857142857,5350,-0.42581874262904834,8,9,2,1.6111329138666206e-4,8,0.015279580187248567,0.037942568711203356,2015-10-01,-6,55115,10
Uzbekistan,201510,2,89621,44810.5,58444,0,0,0,0,-1,2,0,1,6.124188223575362e-7,4,0,0.0865430863907858,2015-10-01,2,89621,10
Viet Nam,201510,1,130,130,130,0,0,0,0,-1,1,0,0,2.739066805161429e-7,9,0,1.2553532353803412e-4,2015-10-01,1,130,10
Dominica,201510,1,13,13,13,0,0,0,0,-1,1,0,0,2.793318731996237e-14,2,0,1.2553532353803411e-5,2015-10-01,1,13,10
South Africa,201510,4,62448,15612,52345,0,0,0,0,-1,4,0,0,5.565695856389273e-9,1,0,0.06030330680233195,2015-10-01,4,62448,10
Bangladesh,201510,1,778,778,778,0,0,0,0,-1,1,0,0,6.173755985944096e-10,8,0,7.512806285583887e-4,2015-10-01,1,778,10
Oman,201510,1,1043,1043,1043,0,0,0,0,-1,1,0,0,8.276641980352638e-10,8,0,0.0010071795573089967,2015-10-01,1,1043,10
Pakistan,201510,1,295,295,295,1,206680,206680,206680,0.9971494141804566,2,1,0,2.3410645477267914e-10,8,0.19958185129877606,2.848686187978466e-4,2015-10-01,0,206975,10
Saudi Arabia,201510,1,30301,30301,30301,0,0,0,0,-1,1,0,0,2.4045112651394992e-8,8,0,0.029260352604045935,2015-10-01,1,30301,10
Turkmenistan,201510,1,933,933,933,0,0,0,0,-1,1,0,0,6.123293708184293e-11,4,0,9.009573604691216e-4,2015-10-01,1,933,10
United Arab Emirates,201510,1,3043,3043,3043,0,0,0,0,-1,1,0,0,1.6682174462389836e-8,8,0,0.002938492227124906,2015-10-01,1,3043,10
"China, Hong Kong SAR",201510,0,0,0,0,10,206067,20606.7,145461,1,10,0,8,2.1801424050656602e-5,1,0.1989899039654775,0,2015-10-01,-10,206067,10
Paraguay,201510,0,0,0,0,1,2795,2795,2795,1,1,0,0,6.814408379344338e-10,5,0.002699009456067733,0,2015-10-01,-1,2795,10
El Salvador,201510,0,0,0,0,2,20292,10146,18731,1,2,0,0,2.2682706560082516e-10,2,0.019595098347952214,0,2015-10-01,-2,20292,10
Montenegro,201510,0,0,0,0,3,52291,17430.3333333333,29942,1,3,0,3,1.0465320488170345e-6,6,0.05049513540867186,0,2015-10-01,-3,52291,10
Georgia,201510,0,0,0,0,2,118076,59038,113363,1,2,0,0,2.7502354773843575e-5,7,0.11402083740059166,0,2015-10-01,-2,118076,10
Iceland,201510,0,0,0,0,2,496,248,370,1,2,0,1,1.3572682035806306e-5,3,4.789655421143455e-4,0,2015-10-01,-2,496,10
Barbados,201510,0,0,0,0,3,346,115.333333333333,176,1,3,0,0,6.896137575291708e-7,3,3.341170918781523e-4,0,2015-10-01,-3,346,10
Panama,201510,0,0,0,0,1,3121,3121,3121,1,1,0,0,1.668815333264704e-17,10,0.0030138134212477265,0,2015-10-01,-1,3121,10
Cyprus,201510,0,0,0,0,2,10238,5119,10181,1,2,0,1,4.068015048481997e-6,3,0.00988638955678764,0,2015-10-01,-2,10238,10
Malta,201510,0,0,0,0,3,17549,5849.66666666667,12246,1,3,0,3,1.562975572973764e-4,3,0.016946303021299697,0,2015-10-01,-3,17549,10
Switzerland,201510,0,0,0,0,13,2343453,180265.615384615,1933540,1,13,0,18,0.061921281571843,9,2.262970235009051,0,2015-10-01,-13,2343453,10
Antigua and Barbuda,201510,0,0,0,0,2,1243,621.5,1230,1,2,0,0,6.312920668826332e-8,2,0.0012003108242905876,0,2015-10-01,-2,1243,10
Mozambique,201510,0,0,0,0,2,8301,4150.5,8276,1,2,0,0,1.6011448715008202e-12,1,0.008015913236070931,0,2015-10-01,-2,8301,10
Bermuda,201510,0,0,0,0,1,13659,13659,13659,1,1,0,0,7.010421414424167e-7,2,0.013189899878507752,0,2015-10-01,-1,13659,10
Greenland,201510,0,0,0,0,3,13591,4530.33333333333,7812,1,3,0,3,3.0131756603800448e-5,6,0.013124235247734012,0,2015-10-01,-3,13591,10
Kyrgyzstan,201510,0,0,0,0,1,3e3,3e3,3e3,1,1,0,0,3.953783602007183e-9,4,0.0028969690047238638,0,2015-10-01,-1,3e3,10
Rep. of Moldova,201510,0,0,0,0,4,34678,8669.5,25402,1,4,0,2,6.607899966912367e-6,7,0.03348703038193805,0,2015-10-01,-4,34678,10
Kuwait,201510,0,0,0,0,11,275038,25003.4545454545,199255,1,11,0,4,2.3321179861258664e-5,8,0.26559218704041404,0,2015-10-01,-11,275038,10
Singapore,201510,0,0,0,0,10,998202,99820.2,871982,1,10,0,8,4.817214918713981e-5,1,0.9639200848177901,0,2015-10-01,-10,998202,10
Saint Vincent and the Grenadines,201510,0,0,0,0,1,222,222,222,1,1,0,0,1.1394051942791887e-8,2,2.1437570634956593e-4,0,2015-10-01,-1,222,10
Botswana,201510,0,0,0,0,1,52345,52345,52345,1,1,0,0,9.913210878373434e-12,1,0.05054728085075689,0,2015-10-01,-1,52345,10
Iran,201511,4,7818068,1954517,7726081,0,0,0,0,-1,4,0,3,2.43625766137722e-4,1,0,5.621646626711794,2015-11-01,4,7818068,11
Guatemala,201511,2,19734,9867,18990,0,0,0,0,-1,2,0,0,2.1626907924064517e-7,2,0,0.014189896344151846,2015-11-01,2,19734,11
Honduras,201511,2,5484,2742,4215,0,0,0,0,-1,2,0,0,3.6887818921366877e-7,2,0,0.0039433156760580075,2015-11-01,2,5484,11
Brazil,201511,2,36828,18414,36300,0,0,0,0,-1,2,0,0,2.7101584465437826e-6,1,0,0.026481478796109466,2015-11-01,2,36828,11
Germany,201511,24,7582817,315950.708333333,1832787,22,36205958,1645725.36363636,29158160,0.6536638898895892,46,838,150,0.9069423569837606,3,26.03419433772754,5.45248744434339,2015-11-01,2,43788775,11
Austria,201511,7,101982,14568.8571428571,53189,11,3442646,312967.818181818,1571987,0.9424582777092547,18,414,65,0.05570131001792098,3,2.4754631544344265,0.07333100278551198,2015-11-01,-4,3544628,11
Belgium,201511,11,717244,65204,429853,8,2770628,346328.5,1049860,0.5887211457301186,19,73,58,0.07202633507140263,3,1.9922430388266312,0.5157402459443016,2015-11-01,3,3487872,11
Czech Rep.,201511,3,10916,3638.66666666667,10671,12,3465485,288790.416666667,2384386,0.993719941974473,15,445,62,0.08226916922938797,3,2.491885726776784,0.007849240320906128,2015-11-01,-9,3476401,11
Estonia,201511,5,21973,4394.6,16932,4,49174,12293.5,47765,0.3823211098148903,9,312,15,0.0013273871127410669,3,0.035358972475287465,0.01579986786105445,2015-11-01,1,71147,11
Finland,201511,3,1437,479,1037,7,1232680,176097.142857143,870357,0.9976712094558295,10,200,20,0.027794894701972016,3,0.8863687759962043,0.0010332867663193576,2015-11-01,-4,1234117,11
France,201511,16,361387,22586.6875,118124,16,7215073,450942.0625,6172246,0.9046026772397663,32,543,113,0.18494578547433396,3,5.188058071627075,0.25985831915090724,2015-11-01,0,7576460,11
Greece,201511,13,1378001,106000.076923077,446045,4,107519,26879.75,56970,-0.855243954978728,17,94,57,0.0081122552848724,3,0.07731242855107238,0.9908630461202791,2015-11-01,9,1485520,11
Hungary,201511,6,27699,4616.5,21858,8,917461,114682.625,572089,0.9413877015531762,14,282,31,0.02378557647247238,3,0.6597079400933362,0.019917195643896927,2015-11-01,-2,945160,11
Italy,201511,17,1678341,98725.9411764706,749125,8,780503,97562.875,600328,-0.3651463858626249,25,1155,77,0.0389402190278873,3,0.5612271544694207,1.2068250136890724,2015-11-01,9,2458844,11
Jordan,201511,7,1218094,174013.428571429,808269,0,0,0,0,-1,7,0,9,0.0024902064728376354,3,0,0.8758805917418313,2015-11-01,7,1218094,11
Latvia,201511,3,66468,22156,66283,7,633391,90484.4285714286,519110,0.8100531678523817,10,144,23,0.014945424815022293,3,0.4554450509434824,0.047794366585744645,2015-11-01,-4,699859,11
Lithuania,201511,3,28920,9640,28667,9,1128624,125402.666666667,762926,0.9500321370073189,12,360,36,0.024294991323130562,3,0.811546446312052,0.02079516581903676,2015-11-01,-6,1157544,11
Netherlands,201511,34,12004472,353072.705882353,5281295,11,11022990,1002090,9640600,-0.04262223948084248,45,530,161,0.4567079258096627,3,7.92617236762047,8.631915138657808,2015-11-01,23,23027462,11
Poland,201511,11,411299,37390.8181818182,147345,8,5720484,715060.5,4752036,0.8658468507447181,19,200,72,0.15474446408727127,3,4.11336145730106,0.2957479566460581,2015-11-01,3,6131783,11
Portugal,201511,8,52280,6535,39120,3,195098,65032.6666666667,136894,0.577327005635101,11,193,29,0.005497333437426491,3,0.14028683474973835,0.03759236753178567,2015-11-01,5,247378,11
Romania,201511,5,22817,4563.4,20184,12,1452889,121074.083333333,446045,0.9690764962668715,17,186,58,0.014210697116758939,3,1.0447118835288554,0.016406753059922605,2015-11-01,-7,1475706,11
Slovakia,201511,4,56522,14130.5,22903,11,691175,62834.0909090909,331443,0.8488104138441106,15,0,41,0.014470356419965557,3,0.49699511531717605,0.0406426128085614,2015-11-01,-7,747697,11
Spain,201511,35,78642148,2246918.51428571,29158160,15,1384156,92277.0666666667,1254872,-0.9654074740225413,50,477,163,1,3,0.9952888499106032,56.54828865924031,2015-11-01,20,80026304,11
Sweden,201511,3,28065,9355,23742,10,5725954,572595.4,4554967,0.9902450791351227,13,46,33,0.14074138768934963,3,4.117294706161023,0.020180370978951128,2015-11-01,-7,5754019,11
Turkey,201511,22,10264034,466547,7213437,0,0,0,0,-1,22,0,68,0.00448913479072365,3,0,7.3804387621795,2015-11-01,22,10264034,11
United Kingdom,201511,12,186134,15511.1666666667,159774,14,13271601,947971.5,7583296,0.9723379900109491,26,805,64,0.29207103907054144,3,9.543054753772271,0.13384119621578797,2015-11-01,-2,13457735,11
Albania,201511,10,697958,69795.8,284101,0,0,0,0,-1,10,0,18,2.0583226141589967e-4,1,0,0.5018724877151887,2015-11-01,10,697958,11
TFYR of Macedonia,201511,12,690466,57538.8333333333,196500,2,64795,32397.5,63645,-0.8284169313654485,14,22,26,0.0011127407431162988,1,0.046591382062395804,0.4964853029877951,2015-11-01,10,755261,11
Croatia,201511,1,2021,2021,2021,9,216150,24016.6666666667,92339,0.9814732480485491,10,434,22,0.0019313125406103585,3,0.15542444992340232,0.0014532168091380806,2015-11-01,-8,218171,11
India,201511,7,144090,20584.2857142857,108911,0,0,0,0,-1,7,0,1,1.3766016886619582e-6,2,0,0.10360910936600991,2015-11-01,7,144090,11
Thailand,201511,6,293593,48932.1666666667,224847,0,0,0,0,-1,6,0,4,2.7329838889810864e-6,2,0,0.21111048126931048,2015-11-01,6,293593,11
Israel,201511,6,130097,21682.8333333333,50600,0,0,0,0,-1,6,0,8,0.00102464653596777,3,0,0.09354732667908801,2015-11-01,6,130097,11
Morocco,201511,12,1978254,164854.5,1254872,0,0,0,0,-1,12,0,31,0.03829321219239717,3,0,1.422479943366969,2015-11-01,12,1978254,11
Australia,201511,4,35259,8814.75,14580,0,0,0,0,-1,4,0,2,7.560104276421693e-8,2,0,0.025353276335180395,2015-11-01,4,35259,11
China,201511,7,3721568,531652.571428571,2944779,0,0,0,0,-1,7,0,3,1.079691925186908e-4,1,0,2.6760243314945016,2015-11-01,7,3721568,11
Japan,201511,4,55654,13913.5,50582,0,0,0,0,-1,4,0,5,2.7576897494850135e-6,2,0,0.0400184702106733,2015-11-01,4,55654,11
Singapore,201511,1,723,723,723,9,952489,105832.111111111,837606,0.9984830237135076,10,6,6,2.2585083501875836e-5,2,0.6848951139629496,5.19879145475919e-4,2015-11-01,-8,953212,11
Viet Nam,201511,2,80089,40044.5,79800,0,0,0,0,-1,2,0,0,5.957972996821457e-6,1,0,0.05758865958785736,2015-11-01,2,80089,11
Egypt,201511,7,180421,25774.4285714286,138900,0,0,0,0,-1,7,0,2,3.478366757294997e-4,3,0,0.12973321619074796,2015-11-01,7,180421,11
Kenya,201511,2,24149,12074.5,24100,0,0,0,0,-1,2,0,0,1.7993062960871659e-6,1,0,0.017364538705529693,2015-11-01,2,24149,11
Russian Federation,201511,2,359,179.5,200,14,20724081,1480291.5,7726081,0.9999653549142944,16,79,14,0.0011516182775508416,1,14.901822297446373,2.581419270067149e-4,2015-11-01,-12,20724440,11
Serbia,201511,5,32328,6465.6,15400,6,293918,48986.3333333333,151010,0.8018182598407336,11,356,23,6.375180847603382e-5,3,0.21134417521437227,0.023245716479869304,2015-11-01,-1,326246,11
Ukraine,201511,2,224,112,200,0,0,0,0,-1,2,0,0,1.493389454175862e-8,1,0,1.6106905751951016e-4,2015-11-01,2,224,11
Ecuador,201511,1,369,369,369,0,0,0,0,-1,1,0,0,6.520023541962621e-7,3,0,2.653325099316931e-4,2015-11-01,1,369,11
Bulgaria,201511,4,28548,7137,15092,5,978437,195687.4,387214,0.9433000491566409,9,0,22,2.7794873060587807e-4,1,0.7035532385366828,0.02052767613422757,2015-11-01,-1,1006985,11
Guyana,201511,1,889,889,889,0,0,0,0,-1,1,0,0,1.1125703186007472e-11,2,0,6.39242822030556e-4,2015-11-01,1,889,11
Saint Vincent and the Grenadines,201511,1,60,60,60,1,263,263,263,0.628482972136223,2,0,1,1.9797137204447006e-9,2,1.8911233092692488e-4,4.3143497549868795e-5,2015-11-01,0,323,11
United States of America,201511,8,681985,85248.125,668118,0,0,0,0,-1,8,0,2,2.7511233409162e-4,2,0,0.49038696960912115,2015-11-01,8,681985,11
Dominican Rep.,201511,4,77391,19347.75,69673,0,0,0,0,-1,4,0,0,7.725481157181344e-5,3,0,0.05564864031469826,2015-11-01,4,77391,11
Norway,201511,1,32623,32623,32623,5,2442897,488579.4,2307088,0.97364351732161325,6,47,9,0.06460274409546501,3,1.7565853455680305,0.02345783867615616,2015-11-01,-4,2475520,11
Costa Rica,201511,3,5364,1788,4922,0,0,0,0,-1,3,0,0,8.120378270106141e-6,2,0,0.00385702868095827,2015-11-01,3,5364,11
Slovenia,201511,3,6315,2105,4698,9,152709,16967.6666666667,53189,0.9205780259583459,12,1156,18,0.0015777997268140664,3,0.10980667278904856,0.00454085311712369,2015-11-01,-6,159024,11
Azerbaijan,201511,1,2022117,2022117,2022117,1,77282,77282,77282,-0.926377025043834,2,0,1,6.420722019672079e-5,1,0.055570262960816,1.4540199972508006,2015-11-01,0,2099399,11
Belize,201511,1,17599,17599,17599,0,0,0,0,-1,1,0,0,5.543299864107744e-7,1,0,0.012654706889669014,2015-11-01,1,17599,11
Belarus,201511,1,604662,604662,604662,15,2108200,140546.666666667,1160600,0.5542257586268671,16,6,13,0.002729708204231638,1,1.5159186922438899,0.4347872252583127,2015-11-01,-14,2712862,11
Kazakhstan,201511,1,50582,50582,50582,6,678313,113052.166666667,403515,0.8612090904725647,7,5,3,2.8824541081212527e-6,1,0.4877465875590692,0.036371406551124384,2015-11-01,-5,728895,11
Seychelles,201511,1,28200,28200,28200,7,11355,1622.14285714286,4767,-0.4258627227910504,8,9,0,6.044633474975541e-5,1,0.008164906911312669,0.020277443848438333,2015-11-01,-6,39555,11
Uzbekistan,201511,2,290011,145005.5,261200,0,0,0,0,-1,2,0,1,9.280758709978951e-7,1,0,0.2085348144655833,2015-11-01,2,290011,11
Georgia,201511,1,4311,4311,4311,1,294572,294572,294572,0.9711525914822857,2,0,1,3.63039075819517e-5,1,0.21181443933766583,0.0030998602989580726,2015-11-01,0,298883,11
Chile,201511,1,1227,1227,1227,0,0,0,0,-1,1,0,0,3.0436596018812664e-5,3,0,8.822845248948168e-4,2015-11-01,1,1227,11
Denmark,201511,4,64324,16081,53138,22,2740984,124590.181818182,1982941,0.9541412208570325,26,184,125,0.06594573269299897,3,1.970927274803826,0.046252705606629335,2015-11-01,-18,2805308,11
Luxembourg,201511,1,253,253,253,9,134293,14921.4444444444,56522,0.9962392044356577,10,462,22,0.0015079146423148204,3,0.09656449527440883,1.8192174800194674e-4,2015-11-01,-8,134546,11
Colombia,201511,3,1075,358.333333333333,791,0,0,0,0,-1,3,0,2,7.312928616530964e-6,3,0,7.729876644351492e-4,2015-11-01,3,1075,11
Afghanistan,201511,1,65284,65284,65284,0,0,0,0,-1,1,0,0,0,4,0,0.046943001567427235,2015-11-01,1,65284,11
Tunisia,201511,1,764,764,764,0,0,0,0,-1,1,0,0,3.8646452064395645e-6,3,0,5.493605354683293e-4,2015-11-01,1,764,11
Bangladesh,201511,1,69,69,69,0,0,0,0,-1,1,0,0,3.4903209324104373e-7,3,0,4.961502218234911e-5,2015-11-01,1,69,11
Lebanon,201511,3,1993,664.333333333333,965,0,0,0,0,-1,3,0,0,3.1906416082383057e-6,3,0,0.0014330831769481416,2015-11-01,3,1993,11
South Africa,201511,4,53810,13452.5,45086,0,0,0,0,-1,4,0,0,1.484218583903761e-9,1,0,0.03869252671930733,2015-11-01,4,53810,11
Ireland,201511,2,60381,30190.5,36774,8,831501,103937.625,336123,0.864598680094452,10,0,21,0.018062751442917,3,0.5978976892702241,0.04341745875931046,2015-11-01,-6,891882,11
Suriname,201511,1,653,653,653,0,0,0,0,-1,1,0,0,8.156870394598336e-6,3,0,4.6954506500107205e-4,2015-11-01,1,653,11
Saudi Arabia,201511,1,25966,25966,25966,0,0,0,0,-1,1,0,0,8.526656767113824e-8,3,0,0.01867106762299822,2015-11-01,1,25966,11
Rep. of Korea,201511,2,1914,957,1227,0,0,0,0,-1,2,0,0,6.04133874174724e-9,2,0,0.0013762775718408145,2015-11-01,2,1914,11
Malaysia,201511,2,841304,420652,837606,8,269847,33730.875,224847,-0.5142928368871558,10,51,11,1.3159279040717164e-5,2,0.1940357230556574,0.6049466177115802,2015-11-01,-6,1111151,11
United Arab Emirates,201511,1,3671,3671,3671,0,0,0,0,-1,1,0,0,6.06912647524318e-9,1,0,0.0026396629917594724,2015-11-01,1,3671,11
Turkmenistan,201511,1,510,510,510,0,0,0,0,-1,1,0,0,4.020724191580815e-11,1,0,3.6671972917388474e-4,2015-11-01,1,510,11
Canada,201511,2,16761,8380.5,15045,15,7357103,490473.533333333,6047071,0.9954539438210415,17,7,5,0.01062794999113955,2,5.290185920910539,0.012052136040555847,2015-11-01,-13,7373864,11
Mexico,201511,1,6047071,6047071,6047071,0,0,0,0,-1,1,0,0,0.0017577876223427479,2,0,4.3481965478730435,2015-11-01,1,6047071,11
Peru,201511,1,859,859,859,0,0,0,0,-1,1,0,0,2.496976747119855e-7,2,0,6.176710732556216e-4,2015-11-01,1,859,11
Ghana,201511,1,2069,2069,2069,0,0,0,0,-1,1,0,0,1.6528019569731677e-5,3,0,0.0014877316071779756,2015-11-01,1,2069,11
New Zealand,201511,1,798,798,798,0,0,0,0,-1,1,0,0,3.6530861473700374e-9,2,0,5.738085174132549e-4,2015-11-01,1,798,11
El Salvador,201511,0,0,0,0,2,23205,11602.5,18990,1,2,0,0,1.5485459448699097e-10,2,0.016685747677411756,0,2015-11-01,-2,23205,11
Paraguay,201511,0,0,0,0,1,528,528,528,1,1,0,0,3.9138150181677883e-11,1,3.7966277843884535e-4,0,2015-11-01,-1,528,11
Iceland,201511,0,0,0,0,3,920,306.666666666667,674,1,3,0,3,1.1517907808505465e-5,3,6.615336290979882e-4,0,2015-11-01,-3,920,11
Barbados,201511,0,0,0,0,4,1302,325.5,889,1,4,0,1,4.575666274199603e-7,2,9.362138968321528e-4,0,2015-11-01,-4,1302,11
Montenegro,201511,0,0,0,0,3,38358,12786,34465,1,3,0,3,2.0738592413404952e-7,1,0.02758163798363112,0,2015-11-01,-3,38358,11
Panama,201511,0,0,0,0,1,4922,4922,4922,1,1,0,0,1.0931750198262924e-9,2,0.0035392049156742367,0,2015-11-01,-1,4922,11
Bosnia Herzegovina,201511,0,0,0,0,5,30763,6152.6,24906,1,5,0,4,2.0965198154828216e-5,3,0.02212039025211023,0,2015-11-01,-5,30763,11
Pakistan,201511,0,0,0,0,1,65284,65284,65284,1,1,0,0,0,4,0.046943001567427235,0,2015-11-01,-1,65284,11
Switzerland,201511,0,0,0,0,11,2493099,226645.363636364,2357891,1,11,0,22,0.0649661782481177,3,1.7926835099680056,0,2015-11-01,-11,2493099,11
Antigua and Barbuda,201511,0,0,0,0,1,757,757,757,1,1,0,0,5.696102195166146e-9,2,5.443271274208446e-4,0,2015-11-01,-1,757,11
Cyprus,201511,0,0,0,0,3,17511,5837,14106,1,3,0,2,6.110598465398123e-5,3,0.012591429759929208,0,2015-11-01,-3,17511,11
Malta,201511,0,0,0,0,2,13199,6599.5,11418,1,2,0,1,3.440789295532759e-5,3,0.009490850402678637,0,2015-11-01,-2,13199,11
Mozambique,201511,0,0,0,0,1,6561,6561,6561,1,1,0,0,2.663374688781856e-13,1,0.004717741457078152,0,2015-11-01,-1,6561,11
Greenland,201511,0,0,0,0,4,11838,2959.5,6217,1,4,0,5,2.0911890477758558e-5,3,0.008512212066589113,0,2015-11-01,-4,11838,11
Bermuda,201511,0,0,0,0,1,6662,6662,6662,1,1,0,0,5.012870920120646e-8,2,0.004790366344620432,0,2015-11-01,-1,6662,11
Rep. of Moldova,201511,0,0,0,0,3,160838,53612.6666666667,156225,1,3,0,2,1.3885347151245726e-4,3,0.11565189764876328,0,2015-11-01,-3,160838,11
Kyrgyzstan,201511,0,0,0,0,1,13600,13600,13600,1,1,0,0,4.01615618366574e-8,1,0.00977919277797026,0,2015-11-01,-1,13600,11
Kuwait,201511,0,0,0,0,8,948458,118557.25,808269,1,8,0,3,1.2006098345822812e-4,3,0.681996589985891,0,2015-11-01,-8,948458,11
Uganda,201511,0,0,0,0,1,49,49,49,1,1,0,0,2.4114090644207812e-12,1,3.5233856332392847e-5,0,2015-11-01,-1,49,11
Botswana,201511,0,0,0,0,1,45086,45086,45086,1,1,0,0,1.830245335928751e-12,1,0.032419462175556406,0,2015-11-01,-1,45086,11
Algeria,201511,0,0,0,0,2,1412,706,713,1,2,0,0,1.9120393889292547e-5,1,0.0010153103090069122,0,2015-11-01,-2,1412,11
"China, Hong Kong SAR",201511,0,0,0,0,10,225169,22516.9,137520,1,10,0,8,1.6737291952979491e-4,2,0.1619096366634401,0,2015-11-01,-10,225169,11
Belgium,201512,10,446950,44695,133113,9,2459136,273237.333333333,1274616,0.6924041477093245,19,218,49,0.061477563792765935,1,1.6224415370860665,0.2948800899993402,2015-12-01,1,2906086,12
Czech Rep.,201512,6,35455,5909.16666666667,15183,11,3162015,287455.909090909,2059690,0.9778230913816236,17,278,50,0.0677399019596076,1,2.0861735491201783,0.02339181919885134,2015-12-01,-5,3197470,12
France,201512,19,492968,25945.6842105263,146461,16,6241169,390073.0625,5263682,0.8535913362023968,35,819,101,0.15657792270111603,1,4.117678658510107,0.32524096253897467,2015-12-01,3,6734137,12
Germany,201512,24,5949499,247895.791666667,973795,22,34532579,1569662.68181818,27852782,0.7060675096767512,46,1581,149,0.846734081655371,1,22.783241981047823,3.925246225687402,2015-12-01,2,40482078,12
Greece,201512,16,3797680,237355,921663,3,8103,2701,4647,-0.9957417435518525,19,24,60,0.016478004290365465,2,0.0053460417703650375,2.5055603986770203,2015-12-01,13,3805783,12
Italy,201512,21,2814930,134044.285714286,1893672,8,1351249,168906.125,799494,-0.35132455902638843,29,1734,89,0.0711061063012596,1,0.8915011225674425,1.8571804715110027,2015-12-01,13,4166179,12
Latvia,201512,3,42258,14086,40351,7,577368,82481.1428571429,461549,0.863601591928034,10,169,16,0.013271367197528331,3,0.3809247741419377,0.027880171927938513,2015-12-01,-4,619626,12
Lithuania,201512,4,99406,24851.5,76035,12,1550815,129234.583333333,916961,0.879524015268258,16,461,43,0.030037007460844017,3,1.0231669465764106,0.06558418218251351,2015-12-01,-8,1650221,12
Morocco,201512,12,2392170,199347.5,1179143,0,0,0,0,-1,12,0,34,0.03869363427271156,1,0,1.5782599952874408,2015-12-01,12,2392170,12
Netherlands,201512,33,7718574,233896.181818182,3432026,10,12217537,1221753.7,11005001,0.22566903845990827,43,645,149,0.43102481484637534,1,8.06065199715912,5.092412564686357,2015-12-01,23,19936111,12
Poland,201512,10,411303,41130.3,157360,8,5250347,656293.375,4232541,0.8547056070226877,18,685,64,0.13819420247469621,1,3.463973142158554,0.2713615967267001,2015-12-01,2,5661650,12
Portugal,201512,6,25434,4239,14959,2,290572,145286,247792,0.839028372878996,8,0,14,0.007977024286148469,3,0.1917080154632247,0.016780356212200958,2015-12-01,4,316006,12
Slovenia,201512,5,65669,13133.8,48403,8,176095,22011.875,62027,0.4567512119256796,13,1705,17,0.0025838578763917536,1,0.11618057824909679,0.04332583203975091,2015-12-01,-3,241764,12
Sweden,201512,3,27955,9318.33333333333,22850,8,4309460,538682.5,3483850,0.9871098338526518,11,0,21,0.10701481803499753,3,2.8432127814040866,0.018443613191479035,2015-12-01,-5,4337415,12
United Kingdom,201512,12,208956,17413,149268,13,16335879,1256606.07692308,12776431,0.9747406365793313,25,430,65,0.3981383932398513,1,10.777772613800943,0.1378609779301983,2015-12-01,-1,16544835,12
United States of America,201512,7,922167,131738.142857143,900570,0,0,0,0,-1,7,0,1,1.71446273883177e-4,4,0,0.6084096385600661,2015-12-01,7,922167,12
Denmark,201512,4,89031,22257.75,73291,22,3468952,157679.636363636,2655765,0.9499542296857517,26,787,118,0.08491645121808873,3,2.2886785500914892,0.05873916387231515,2015-12-01,-18,3557983,12
Spain,201512,34,82142978,2415969.94117647,27852782,15,1397836,93189.0666666667,1179143,-0.9665352554501085,49,249,157,1,1,0.9222373990028363,54.1947169604068,2015-12-01,19,83540814,12
Thailand,201512,5,367600,73520,291427,0,0,0,0,-1,5,0,3,6.129027733649128e-6,5,0,0.2425280704413412,2015-12-01,5,367600,12
China,201512,5,4911385,982277,4003800,0,0,0,0,-1,5,0,2,5.948718839872586e-4,5,0,3.240339301535763,2015-12-01,5,4911385,12
Turkey,201512,26,14280633,549255.115384615,9346991,3,180021,60007,167412,-0.9751019559696262,29,356,76,0.01383953550024812,3,0.11877079915375595,9.42180186662389,2015-12-01,23,14460654,12
Romania,201512,3,1029,343,487,12,2209651,184137.583333333,921663,0.9990690647221669,15,595,52,0.01719526676166099,1,1.4578411136528293,6.788938642114801e-4,2015-12-01,-9,2210680,12
Jordan,201512,8,1015306,126913.25,476756,0,0,0,0,-1,8,0,10,0.0029597605817737347,6,0,0.6698590998028193,2015-12-01,8,1015306,12
Lebanon,201512,3,114691,38230.3333333333,110337,0,0,0,0,-1,3,0,1,1.8388422182726442e-5,7,0,0.07566862602553825,2015-12-01,3,114691,12
Oman,201512,1,705,705,705,0,0,0,0,-1,1,0,0,8.601565641439537e-10,7,0,4.651313646929966e-4,2015-12-01,1,705,12
Pakistan,201512,1,438,438,438,1,4965,4965,4965,0.8378678511937813,2,1,0,5.343951659614745e-10,7,0.0032757123768804653,2.889752308305426e-4,2015-12-01,0,5403,12
Saudi Arabia,201512,1,17313,17313,17313,0,0,0,0,-1,1,0,0,2.1123248904674707e-8,7,0,0.011422438747418228,2015-12-01,1,17313,12
India,201512,7,148786,21255.1428571429,115367,0,0,0,0,-1,7,0,1,9.149887076705899e-7,7,0,0.09816317053505276,2015-12-01,7,148786,12
Austria,201512,8,102070,12758.75,50140,12,3339772,278314.333333333,1338839,0.940688735857137,20,83,65,0.05231130699560883,1,2.2034506498205086,0.06734178495633214,2015-12-01,-4,3441842,12
Hungary,201512,5,5190,1038,3122,6,722450,120408.333333333,447672,0.9857347039744929,11,418,28,0.01832939115030862,1,0.4766441906701495,0.0034241585571016344,2015-12-01,-1,727640,12
Slovakia,201512,4,48402,12100.5,33881,10,691786,69178.6,286585,0.8692170097326625,14,0,37,0.01412991921532144,1,0.4564132854688076,0.031933742289177905,2015-12-01,-6,740188,12
Belarus,201512,3,585484,195161.333333333,579639,13,4631100,356238.461538462,1539900,0.7755297336341177,16,480,16,0.03246680395168271,2,3.0554182454322505,0.3862793928027155,2015-12-01,-10,5216584,12
Georgia,201512,2,49674,24837,42641,3,618222,206074,612684,0.8512522907758094,5,210,3,2.439089307490192e-4,6,0.4078786419052961,0.032772958028028244,2015-12-01,-1,667896,12
Russian Federation,201512,3,187783,62594.3333333333,167412,17,29548013,1738118.41176471,14536412,0.987369902591476,20,299,17,0.005361945496392668,6,19.494620724335327,0.12389186249098579,2015-12-01,-14,29735796,12
Australia,201512,4,38042,9510.5,17462,1,1840,1840,1840,-0.9077277970011534,5,1,2,1.8930349698793922e-7,5,0.001213959873808672,0.025098620390994295,2015-12-01,3,39882,12
Japan,201512,3,51567,17189,43038,1,10253,10253,10253,-0.668295050145584,4,3,2,8.865545654581119e-7,2,0.0067645274924784315,0.03402188522428901,2015-12-01,2,61820,12
Rep. of Korea,201512,2,5354,2677,4767,0,0,0,0,-1,2,0,0,2.3170817495642716e-8,5,0,0.003532359328462842,2015-12-01,2,5354,12
Malaysia,201512,2,863051,431525.5,858596,6,336900,56150,291427,-0.43847707114707185,8,6,9,4.3078306654198076e-6,5,0.22227341385116392,0.5694072190491566,2015-12-01,-4,1199951,12
Viet Nam,201512,3,127773,42591,125400,0,0,0,0,-1,3,0,0,1.1253498073091997e-4,2,0,0.08429961682399753,2015-12-01,3,127773,12
South Africa,201512,4,71375,17843.75,56670,0,0,0,0,-1,4,0,0,2.601832580604404e-9,4,0,0.047090427170159765,2015-12-01,4,71375,12
Kenya,201512,1,12,12,12,0,0,0,0,-1,1,0,0,5.088875199772531e-18,8,0,7.917129611795687e-6,2015-12-01,1,12,12
Cayman Isds,201512,1,13,13,13,0,0,0,0,-1,1,0,0,1.6894311237496436e-11,7,0,8.57689041277866e-6,2015-12-01,1,13,12
United Arab Emirates,201512,1,2433,2433,2433,0,0,0,0,-1,1,0,0,3.1618332923311935e-9,7,0,0.0016051980287915754,2015-12-01,1,2433,12
Egypt,201512,7,358533,51219,315500,0,0,0,0,-1,7,0,8,0.0011238049208751487,1,0,0.2365460192588286,2015-12-01,7,358533,12
Iran,201512,5,14898671,2979734.2,14536412,0,0,0,0,-1,5,0,2,0.0021554367705390112,5,0,9.829559112541805,2015-12-01,5,14898671,12
Uzbekistan,201512,2,653518,326759,537997,0,0,0,0,-1,2,0,1,1.775775362222186e-5,5,0,0.43116555913679117,2015-12-01,2,653518,12
Afghanistan,201512,1,4965,4965,4965,0,0,0,0,-1,1,0,0,7.333578050392194e-14,7,0,0.0032757123768804653,2015-12-01,1,4965,12
Canada,201512,3,16166,5388.66666666667,10706,12,12811990,1067665.83333333,11302052,0.9974796065779057,15,412,6,0.006887352177998422,4,8.452848784585852,0.010665693108690756,2015-12-01,-9,12828156,12
Dominican Rep.,201512,3,58751,19583.6666666667,58134,0,0,0,0,-1,3,0,1,1.1836234174026487e-5,4,0,0.0387616068185507,2015-12-01,3,58751,12
Guatemala,201512,2,32094,16047,31285,0,0,0,0,-1,2,0,0,1.5400461994716585e-7,4,0,0.021174363146747564,2015-12-01,2,32094,12
Honduras,201512,3,79132,26377.3333333333,57234,0,0,0,0,-1,3,0,0,1.4030696124933253e-5,4,0,0.05220819170338469,2015-12-01,3,79132,12
Israel,201512,6,436032,72672,252300,0,0,0,0,-1,6,0,3,0.0026388903132815796,2,0,0.2876768215742081,2015-12-01,6,436032,12
Mexico,201512,3,11570305,3856768.33333333,11302052,0,0,0,0,-1,3,0,0,0.002382913341799234,2,0,7.633633694417308,2015-12-01,3,11570305,12
Peru,201512,1,78,78,78,0,0,0,0,-1,1,0,0,1.484769118869351e-8,4,0,5.146134247667197e-5,2015-12-01,1,78,12
Switzerland,201512,1,41,41,41,12,2180640,181720,2083340,0.999962397067705,13,279,20,0.057726546509367115,4,1.4387007930555122,2.705019284030193e-5,2015-12-01,-11,2180681,12
Ireland,201512,2,30124,15062,28157,7,732715,104673.571428571,289487,0.9210213426424186,9,99,19,0.01591336048193487,7,0.4834166352922397,0.019874634368811105,2015-12-01,-5,762839,12
Albania,201512,7,282614,40373.4285714286,165829,0,0,0,0,-1,7,0,5,8.957217220419538e-6,6,0,0.1864576390090022,2015-12-01,7,282614,12
Bulgaria,201512,3,18738,6246,14151,6,1290708,215118,735829,0.9713802631036331,9,107,16,0.0014105417827798609,1,0.8515585439151323,0.012362597888818966,2015-12-01,-3,1309446,12
Brazil,201512,2,3126,1563,1854,0,0,0,0,-1,2,0,0,6.0420144257090225e-9,5,0,0.0020624122638727765,2015-12-01,2,3126,12
Saint Vincent and the Grenadines,201512,1,80,80,80,1,559,559,559,0.7496087636932708,2,0,1,2.6559233470220178e-9,4,3.688062877494824e-4,5.278086407863791e-5,2015-12-01,0,639,12
Serbia,201512,4,204585,51146.25,114920,6,305963,50993.8333333333,165829,0.19856702993646044,10,0,20,0.0010849251244077459,6,0.20186239395115366,0.1349771634691017,2015-12-01,-2,510548,12
Bosnia Herzegovina,201512,1,5500,5500,5500,5,64583,12916.6,26286,0.8430432487193756,6,8,3,6.193344795259568e-4,6,0.042609331809883404,0.0036286844054063566,2015-12-01,-4,70083,12
Estonia,201512,4,31135,7783.75,24165,3,241970,80656.6666666667,239286,0.7719924571135643,7,53,12,0.006638862821482132,3,0.1596423210138502,0.020541652538604894,2015-12-01,1,273105,12
Finland,201512,1,14,14,14,8,892772,111596.5,692535,0.999968637501036,9,75,20,0.020984728381012455,3,0.5890159698151716,9.236651213761634e-6,2015-12-01,-7,892786,12
TFYR of Macedonia,201512,5,137530,27506,94400,3,161258,53752.6666666667,105706,0.07941416656626103,8,0,11,1.4422792888129065e-4,6,0.10639170724491241,0.0907369029591884,2015-12-01,2,298788,12
Croatia,201512,1,3294,3294,3294,10,174602,17460.2,75688,0.9629671268606377,11,90,24,0.0027840758405779783,1,0.11519555537322922,0.002173252078437916,2015-12-01,-9,177896,12
Cameroon,201512,1,350800,350800,350800,0,0,0,0,-1,1,0,0,3.1478291714899054e-4,2,0,0.23144408898482724,2015-12-01,1,350800,12
Guinea,201512,1,25100,25100,25100,0,0,0,0,-1,1,0,0,2.2522951027486416e-5,2,0,0.016559996104672646,2015-12-01,1,25100,12
Azerbaijan,201512,1,531398,531398,531398,1,341120,341120,341120,-0.21807916856729603,2,0,1,9.907212665156891e-5,5,0.22505760443131206,0.3505955701207504,2015-12-01,0,872518,12
Kazakhstan,201512,1,39119,39119,39119,7,1311433,187347.571428571,711430,0.9420696130174921,8,52,6,4.291274462666739e-5,5,0.8652320865155044,0.025809182773652958,2015-12-01,-6,1350552,12
Belize,201512,1,72705,72705,72705,0,0,0,0,-1,1,0,0,1.0774539220539034e-5,6,0,0.04796790903546712,2015-12-01,1,72705,12
Ecuador,201512,2,23452,11726,23e3,0,0,0,0,-1,2,0,0,4.129642603217157e-6,6,0,0.015472710304652705,2015-12-01,2,23452,12
Luxembourg,201512,1,734,734,734,9,117555,13061.6666666667,38470,0.9875897167107677,10,191,24,0.0015142989678227877,1,0.0775581809595535,4.8426442792150285e-4,2015-12-01,-8,118289,12
Colombia,201512,1,422,422,422,0,0,0,0,-1,1,0,0,9.875782672432933e-6,1,0,2.78419058014815e-4,2015-12-01,1,422,12
Costa Rica,201512,2,5532,2766,5295,0,0,0,0,-1,2,0,0,5.546351998812749e-6,1,0,0.0036497967510378117,2015-12-01,2,5532,12
Sri Lanka,201512,1,33,33,33,0,0,0,0,-1,1,0,0,5.2650384731640916e-8,4,0,2.177210643243814e-5,2015-12-01,1,33,12
Dominica,201512,1,47,47,47,0,0,0,0,-1,1,0,0,7.008653368886719e-15,4,0,3.100875764619977e-5,2015-12-01,1,47,12
Bangladesh,201512,1,234,234,234,0,0,0,0,-1,1,0,0,1.0126477846220934e-6,1,0,1.543840274300159e-4,2015-12-01,1,234,12
Tunisia,201512,1,388,388,388,0,0,0,0,-1,1,0,0,1.6790911984201118e-6,1,0,2.559871907813939e-4,2015-12-01,1,388,12
Cyprus,201512,2,11964,5982,11878,2,44329,22164.5,35098,0.5749382694118274,4,0,5,2.493307077048046e-4,2,0.02924653654677425,0.007893378222960299,2015-12-01,0,56293,12
Norway,201512,1,33563,33563,33563,5,1873728,374745.6,1798887,0.9648055802706561,6,0,11,0.05034112660836943,3,1.2362122861042257,0.022143551763391552,2015-12-01,-4,1907291,12
Suriname,201512,1,2469,2469,2469,0,0,0,0,-1,1,0,0,2.9412734071143836e-5,1,0,0.0016289494176269625,2015-12-01,1,2469,12
"China, Hong Kong SAR",201512,1,993,993,993,12,232881,19406.75,143234,0.991508248030991,13,10,6,1.7186308839849506e-4,5,0.15364575509371595,6.551424753760931e-4,2015-12-01,-11,233874,12
New Zealand,201512,1,747,747,747,0,0,0,0,-1,1,0,0,3.5482584631442894e-9,5,0,4.928413183342815e-4,2015-12-01,1,747,12
Ukraine,201512,1,60071,60071,60071,0,0,0,0,-1,1,0,0,2.2943872366047342e-4,1,0,0.03963249107584822,2015-12-01,1,60071,12
Bermuda,201512,0,0,0,0,1,15682,15682,15682,1,1,0,0,7.430901984927229e-8,4,0.010346368881014997,0,2015-12-01,-1,15682,12
Greenland,201512,0,0,0,0,4,9309,2327.25,5689,1,4,0,5,1.7625093300669092e-5,3,0.006141713296350504,0,2015-12-01,-4,9309,12
Kyrgyzstan,201512,0,0,0,0,1,27186,27186,27186,1,1,0,0,4.4697248353861856e-7,5,0.017936257135523128,0,2015-12-01,-1,27186,12
Rep. of Moldova,201512,0,0,0,0,2,301494,150747,301316,1,2,0,1,1.1533852343609086e-4,3,0.19891392293156074,0,2015-12-01,-2,301494,12
Kuwait,201512,0,0,0,0,7,721100,103014.285714286,476756,1,7,0,0,4.414447486320776e-5,7,0.4757535135888225,0,2015-12-01,-7,721100,12
Singapore,201512,0,0,0,0,11,984955,89541.3636363636,858596,1,11,0,5,3.251497864355633e-5,4,0.6498346997321851,0,2015-12-01,-11,984955,12
French Polynesia,201512,0,0,0,0,1,37,37,37,1,1,0,0,1.6011952150796343e-7,1,2.4411149636370034e-5,0,2015-12-01,-1,37,12
Uganda,201512,0,0,0,0,1,12,12,12,1,1,0,0,8.90553159960193e-18,8,7.917129611795687e-6,0,2015-12-01,-1,12,12
Botswana,201512,0,0,0,0,1,56670,56670,56670,1,1,0,0,4.075163626665044e-12,4,0.03738864459170513,0,2015-12-01,-1,56670,12
Seychelles,201512,0,0,0,0,8,8276,1034.5,3756,1,8,0,2,4.702023828646949e-5,7,0.005460180388935092,0,2015-12-01,-8,8276,12
Paraguay,201512,0,0,0,0,1,1854,1854,1854,1,1,0,0,3.096097115917607e-13,5,0.0012231965250224337,0,2015-12-01,-1,1854,12
Armenia,201512,0,0,0,0,1,7600,7600,7600,1,1,0,0,2.907014103653473e-6,3,0.005014182087470602,0,2015-12-01,-1,7600,12
Barbados,201512,0,0,0,0,3,587,195.666666666667,292,1,3,0,1,3.214153563542809e-6,4,3.8727959017700566e-4,0,2015-12-01,-3,587,12
El Salvador,201512,0,0,0,0,2,53049,26524.5,31285,1,2,0,0,8.57292002198538e-9,4,0.03499965073134578,0,2015-12-01,-2,53049,12
Montenegro,201512,0,0,0,0,4,43005,10751.25,41468,1,4,0,4,2.5167945738306787e-6,6,0.028373013246272793,0,2015-12-01,-4,43005,12
Iceland,201512,0,0,0,0,1,291,291,291,1,1,0,0,3.4666284385283194e-6,1,1.919903930860454e-4,0,2015-12-01,-1,291,12
Antigua and Barbuda,201512,0,0,0,0,2,1184,592,1137,1,2,0,0,5.387664575971084e-9,4,7.811567883638411e-4,0,2015-12-01,-2,1184,12
Bolivia,201512,0,0,0,0,1,39,39,39,1,1,0,0,9.862736302491144e-13,7,2.5730671238335984e-5,0,2015-12-01,-1,39,12
Mozambique,201512,0,0,0,0,1,11841,11841,11841,1,1,0,0,8.515011316771386e-13,4,0.007812227644439394,0,2015-12-01,-1,11841,12
Panama,201512,0,0,0,0,1,5295,5295,5295,1,1,0,0,8.116810954378097e-10,1,0.0034934334412048467,0,2015-12-01,-1,5295,12
Malta,201512,0,0,0,0,3,11932,3977.33333333333,8375,1,3,0,3,6.020100679232297e-5,1,0.007872265877328845,0,2015-12-01,-3,11932,12
Morocco,201601,10,1557164,155716.4,988671,0,0,0,0,-1,10,0,19,0.03023807513051812,1,0,1.0755565883430889,2016-01-01,10,1557164,1
Netherlands,201601,33,7752687,234929.909090909,3048553,9,12513262,1390362.44444444,10730918,0.23490511103131662,42,365,154,0.41299837104922815,2,8.643098213009816,5.3548974804271205,2016-01-01,24,20265949,1
Bangladesh,201601,2,74,37,41,0,0,0,0,-1,2,0,0,8.967662032713716e-8,3,0,5.111291266519684e-5,2016-01-01,2,74,1
Denmark,201601,6,104589,17431.5,94526,24,2961713,123404.708333333,2252178,0.9317816705595209,30,1343,133,0.07137673284391273,2,2.0456997014645695,0.07224119490189558,2016-01-01,-18,3066302,1
Dominican Rep.,201601,3,57939,19313,57627,0,0,0,0,-1,3,0,0,8.956530712829063e-5,3,0,0.04001933847174108,2016-01-01,3,57939,1
France,201601,18,386558,21475.4444444444,116539,12,6504455,542037.916666667,5839966,0.8878080769837468,30,808,90,0.16839739113002716,1,4.49272486959058,0.26700142289234,2016-01-01,6,6891013,1
Germany,201601,24,6352573,264690.541666667,1516685,25,33755622,1350224.88,28912222,0.6832281781815412,49,1414,148,0.8490510704489969,2,23.31551566547834,4.3878176884903715,2016-01-01,-1,40108195,1
Italy,201601,22,1470368,66834.9090909091,594715,9,2435663,270629.222222222,1097675,0.24712937506128344,31,1162,107,0.04613275673002125,2,1.6823490567682613,1.015605286077029,2016-01-01,13,3906031,1
Turkey,201601,22,5330491,242295.045454545,1703159,1,435478,435478,435478,-0.8489488930655021,23,656,63,0.01184220984701954,2,0.3007912024542512,3.681850283048889,2016-01-01,21,5765969,1
Portugal,201601,8,15668,1958.5,5085,4,492451,123112.75,436590,0.9383294070877097,12,346,25,0.013198584678774297,2,0.3401433102012007,0.010822123184301407,2016-01-01,4,508119,1
India,201601,7,49489,7069.85714285714,39225,0,0,0,0,-1,7,0,4,1.9110436655592847e-6,1,0,0.03418279641740441,2016-01-01,7,49489,1
Spain,201601,36,87324214,2425672.61111111,28912222,15,1165508,77700.5333333333,988671,-0.9736577768884843,51,466,162,1,2,0.8050339001971384,60.31614761809405,2016-01-01,21,88489722,1
Thailand,201601,5,326573,65314.6,248932,0,0,0,0,-1,5,0,2,7.964888537834098e-5,4,0,0.22556888145690984,2016-01-01,5,326573,1
Sweden,201601,2,20742,10371,16210,7,6003822,857688.857142857,4752988,0.9931141905040763,9,0,18,0.14330206859330882,2,4.146930128964695,0.014326811277047472,2016-01-01,-5,6024564,1
Brazil,201601,2,17927,8963.5,12782,0,0,0,0,-1,2,0,0,1.1759785544346074e-4,2,0,0.012382448450661944,2016-01-01,2,17927,1
Iran,201601,3,15729175,5243058.33333333,15701863,0,0,0,0,-1,3,0,2,0.0017777773732137732,5,0,10.864377676629697,2016-01-01,3,15729175,1
Bahamas,201601,1,115,115,115,0,0,0,0,-1,1,0,0,3.9505377883073684e-12,6,0,7.943222914185995e-5,2016-01-01,1,115,1
Guyana,201601,1,1529,1529,1529,0,0,0,0,-1,1,0,0,5.2525090030724055e-11,6,0,0.0010561032900687293,2016-01-01,1,1529,1
United Kingdom,201601,11,538303,48936.6363636364,303829,11,16259806,1478164.18181818,12090486,0.9359090954821164,22,862,58,0.38421373613574544,2,11.230892486905995,0.3718139760326143,2016-01-01,0,16798109,1
United States of America,201601,8,904483,113060.375,872636,0,0,0,0,-1,8,0,1,0.0013491314176295325,6,0,0.6247400079210167,2016-01-01,8,904483,1
Latvia,201601,3,44768,14922.6666666667,41177,6,541743,90290.5,479637,0.8473413115866539,9,92,18,0.013330321060466586,2,0.3741900357565099,0.03092193073237206,2016-01-01,-3,586511,1
Israel,201601,6,168701,28116.8333333333,72471,0,0,0,0,-1,6,0,3,0.0016264916439497174,3,0,0.11652431729096449,2016-01-01,6,168701,1
New Zealand,201601,2,1942,971,1390,0,0,0,0,-1,2,0,0,2.1593826541397774e-10,4,0,0.001341368599943409,2016-01-01,2,1942,1
Australia,201601,4,27149,6787.25,19936,0,0,0,0,-1,4,0,4,1.1346867347827967e-8,4,0,0.018752222512803098,2016-01-01,4,27149,1
Malaysia,201601,4,790395,197598.75,766555,7,259851,37121.5714285714,248932,-0.5051616478425055,11,19,13,1.2823258425445716e-5,1,0.17948299282383873,0.5459377108920035,2016-01-01,-3,1050246,1
Rep. of Korea,201601,3,17260,5753.33333333333,12730,0,0,0,0,-1,3,0,2,3.799964696513171e-9,4,0,0.011921741521639155,2016-01-01,3,17260,1
China,201601,5,3094339,618867.8,2885969,0,0,0,0,-1,5,0,1,3.2680417326632374e-4,4,0,2.1373064738312504,2016-01-01,5,3094339,1
Japan,201601,3,25699,8566.33333333333,20617,2,22130,11065,12730,-0.07462000041815635,5,5,4,5.3671958298131136e-6,4,0.015285523747037922,0.017750685710579646,2016-01-01,1,47829,1
Albania,201601,1,11889,11889,11889,0,0,0,0,-1,1,0,0,9.058278923961403e-8,7,0,0.008211911063196287,2016-01-01,1,11889,1
Greece,201601,16,4255597,265974.8125,1091754,3,9537,3179,6757,-0.9955279247967356,19,159,57,0.015028261329530269,7,0.006587349298486247,2.93940483512532,2016-01-01,13,4265134,1
Poland,201601,10,505358,50535.8,215100,10,5795961,579596.1,5411221,0.8396024705303763,20,187,74,0.15117477380012856,2,4.003357410863337,0.3490583691710614,2016-01-01,0,6301319,1
Slovakia,201601,3,15874,5291.33333333333,13483,9,681490,75721.1111111111,307825,0.9544742774218342,12,109,40,0.015108787472643397,2,0.4707153898946621,0.010964410481720739,2016-01-01,-6,697364,1
Ireland,201601,2,225478,112739,211922,7,991566,141652.285714286,457312,0.6294661491285443,9,0,15,0.023951415467995202,1,0.6848895454024132,0.15574104489085477,2016-01-01,-5,1217044,1
Jordan,201601,9,667740,74193.3333333333,234252,0,0,0,0,-1,9,0,9,0.0031893380677152383,2,0,0.4612180581494397,2016-01-01,9,667740,1
Egypt,201601,5,29869,5973.8,22688,0,0,0,0,-1,5,0,8,5.640330696462376e-4,2,0,0.020630967410767087,2016-01-01,5,29869,1
Guinea,201601,1,26500,26500,26500,0,0,0,0,-1,1,0,0,7.530023021669842e-6,7,0,0.0183039484544286,2016-01-01,1,26500,1
Russian Federation,201601,2,435678,217839,435478,15,20088957,1339263.8,15701863,0.9575458467349115,17,685,8,0.004205654628398814,5,13.875744657782361,0.30092934546145444,2016-01-01,-13,20524635,1
Cameroon,201601,1,288900,288900,288900,0,0,0,0,-1,1,0,0,8.209145852688378e-5,7,0,0.19954757390507255,2016-01-01,1,288900,1
Austria,201601,7,99699,14242.7142857143,58885,12,3285313,273776.083333333,1604869,0.9410938572743612,19,200,55,0.047423417201872375,2,2.2692150871194032,0.06886359837577649,2016-01-01,-5,3385012,1
Belgium,201601,10,471415,47141.5,345022,8,2582247,322780.875,1393347,0.6912461169572794,18,162,53,0.06251082742147665,2,1.783596829607656,0.32561342870356447,2016-01-01,2,3053662,1
Bulgaria,201601,5,154441,30888.2,134564,5,843662,168732.4,500063,0.6905309371878453,10,172,23,0.0063944395685733525,2,0.582730028715477,0.10667472087737385,2016-01-01,0,998103,1
Chile,201601,2,13134,6567,12729,0,0,0,0,-1,2,0,0,2.9156937659756746e-4,3,0,0.009071851283036423,2016-01-01,2,13134,1
Colombia,201601,1,7610,7610,7610,0,0,0,0,-1,1,0,0,1.7393966452183295e-4,2,0,0.005256341424083081,2016-01-01,1,7610,1
Costa Rica,201601,2,4860,2430,4478,0,0,0,0,-1,2,0,0,1.565442617174259e-5,3,0,0.0033568750750386034,2016-01-01,2,4860,1
Czech Rep.,201601,6,119069,19844.8333333333,58e3,10,3349942,334994.2,2115065,0.9313527688439155,16,92,49,0.06951632650594944,2,2.3138553091820926,0.08224274862340977,2016-01-01,-4,3469011,1
Ecuador,201601,3,552,184,198,0,0,0,0,-1,3,0,3,1.0216515057866386e-5,2,0,3.812746998809278e-4,2016-01-01,3,552,1
Luxembourg,201601,3,378,126,250,8,149737,18717.125,55788,0.9949638610398694,11,269,28,0.0020524658806725473,2,0.10342559734795378,2.610902836141136e-4,2016-01-01,-5,150115,1
Romania,201601,3,1218,406,949,11,1980093,180008.454545455,861361,0.9987705110404171,14,178,41,0.01224873562496039,2,1.3676800078103732,8.412909138676994e-4,2016-01-01,-8,1981311,1
Estonia,201601,3,71466,23822,66350,3,44632,14877.3333333333,39366,-0.23113231924753225,6,0,10,0.0011170059521710967,2,0.030827993487473858,0.04936264076393186,2016-01-01,0,116098,1
Lithuania,201601,4,113327,28331.75,91926,10,1120337,112033.7,681944,0.8162757444490558,14,145,36,0.019710614717176635,7,0.7738336113052519,0.0782766628866049,2016-01-01,-6,1233664,1
"China, Hong Kong SAR",201601,1,2134,2134,2134,11,210769,19160.8181818182,154938,0.9799533120716947,12,64,9,1.453149894001596e-5,4,0.1455813174260929,0.0014739858868585143,2016-01-01,-10,212903,1
Canada,201601,2,12970,6485,12954,15,16943750,1129583.33333333,13687415,0.9984702230148284,17,191,7,0.057430154906175125,3,11.70330289149904,0.00895857401712977,2016-01-01,-13,16956720,1
Cocos Isds,201601,1,111,111,111,0,0,0,0,-1,1,0,0,1.7161021047615746e-7,3,0,7.666936899779527e-5,2016-01-01,1,111,1
Honduras,201601,2,198980,99490,135908,2,5651,2825.5,5632,-0.9447688766609165,4,95,2,0.001908037843632873,6,0.003903230668527397,0.1374384778664982,2016-01-01,0,204631,1
Mexico,201601,2,13696815,6848407.5,13687415,0,0,0,0,-1,2,0,0,0.021161264142799514,4,0,9.460596066031867,2016-01-01,2,13696815,1
Peru,201601,1,2249,2249,2249,0,0,0,0,-1,1,0,0,3.4770393096499433e-6,3,0,0.0015534181160003744,2016-01-01,1,2249,1
Norway,201601,1,46090,46090,46090,5,2210433,442086.6,2176248,0.9591495411303143,6,0,11,0.05877563950299504,2,1.5267793092063386,0.03183505600998544,2016-01-01,-4,2256523,1
Hungary,201601,4,4771,1192.75,2335,8,1295080,161885,641872,0.9926591586266426,12,140,32,0.025977900816690023,2,0.8945312288438261,0.003295401436833164,2016-01-01,-4,1299851,1
Slovenia,201601,5,65138,13027.6,27802,8,181723,22715.375,77772,0.4722698198581388,13,1100,18,0.0027661461399086226,2,0.1255188084899671,0.04499179601602151,2016-01-01,-3,246861,1
Cyprus,201601,1,5908,5908,5908,2,43332,21666,29238,0.7600324939073924,3,0,3,3.4151381427937466e-4,7,0.029930063940652833,0.004080744432783554,2016-01-01,-1,49240,1
Lebanon,201601,2,6887,3443.5,4752,0,0,0,0,-1,2,0,1,2.1559835263161613e-5,1,0,0.004756954453043387,2016-01-01,2,6887,1
Tunisia,201601,1,310,310,310,0,0,0,0,-1,1,0,0,1.4053264176213212e-6,1,0,2.141216611650138e-4,2016-01-01,1,310,1
Kenya,201601,1,174,174,174,0,0,0,0,-1,1,0,0,1.9345401360025735e-6,2,0,1.201844162668142e-4,2016-01-01,1,174,1
Croatia,201601,1,59,59,59,6,173352,28892,94379,0.9993195356695942,7,54,15,0.00337332246868521,2,0.11973683292347571,4.075218712495424e-5,2016-01-01,-5,173411,1
Afghanistan,201601,1,4413,4413,4413,0,0,0,0,-1,1,0,0,0,8,0,0.003048125453939374,2016-01-01,1,4413,1
Azerbaijan,201601,1,107673,107673,107673,0,0,0,0,-1,1,0,0,1.2190473544067764e-5,5,0,0.07437136007296946,2016-01-01,1,107673,1
Armenia,201601,1,284022,284022,284022,1,11658,11658,11658,-0.9211444805194805,2,0,1,3.271420813310926e-5,5,0.008052355889876552,0.19617826595938564,2016-01-01,0,295680,1
Belize,201601,1,32671,32671,32671,0,0,0,0,-1,1,0,0,3.6989306618880713e-6,5,0,0.022566350941684406,2016-01-01,1,32671,1
Br. Virgin Isds,201601,1,45437,45437,45437,0,0,0,0,-1,1,0,0,5.144265938734071e-6,5,0,0.031384019091466875,2016-01-01,1,45437,1
Belarus,201601,1,267476,267476,267476,9,2144600,238288.888888889,1150500,0.7782192600896489,10,98,7,0.010555292497974869,7,1.4813074662402859,0.18474969497346205,2016-01-01,-8,2412076,1
Georgia,201601,1,42560,42560,42560,2,300441,150220.5,284787,0.7518374581998303,3,49,2,9.63566795041009e-5,5,0.2075191161357352,0.029396831932848345,2016-01-01,-1,343001,1
Kazakhstan,201601,1,4919,4919,4919,0,0,0,0,-1,1,0,0,5.569171413655782e-7,5,0,0.0033976272621635576,2016-01-01,1,4919,1
Uzbekistan,201601,1,280448,280448,280448,0,0,0,0,-1,1,0,0,3.175163619930167e-5,5,0,0.19370965042066385,2016-01-01,1,280448,1
Dominica,201601,1,57,57,57,0,0,0,0,-1,1,0,0,9.668086102313005e-14,6,0,3.9370757052921895e-5,2016-01-01,1,57,1
Oman,201601,1,5731,5731,5731,0,0,0,0,-1,1,0,0,4.7086202664947605e-8,1,0,0.003958487871408691,2016-01-01,1,5731,1
Saudi Arabia,201601,1,142505,142505,142505,0,0,0,0,-1,1,0,0,1.1708287056036557e-6,1,0,0.09843034620748481,2016-01-01,1,142505,1
Sri Lanka,201601,1,146,146,146,0,0,0,0,-1,1,0,0,1.1995438072664489e-9,1,0,1.0084439525836135e-4,2016-01-01,1,146,1
Switzerland,201601,1,40,40,40,13,2405250,185019.230769231,2285260,0.9999667399773,14,54,34,0.06167893057148254,2,1.6613423403779015,2.7628601440646944e-5,2016-01-01,-12,2405290,1
Indonesia,201601,1,11,11,11,0,0,0,0,-1,1,0,0,9.704230284630443e-12,4,0,7.597865396177909e-6,2016-01-01,1,11,1
Viet Nam,201601,1,234,234,234,0,0,0,0,-1,1,0,0,2.0643545740034585e-10,4,0,1.6162731842778462e-4,2016-01-01,1,234,1
South Africa,201601,3,9320,3106.66666666667,4920,0,0,0,0,-1,3,0,0,3.0877099699600947e-9,4,0,0.006437464135670737,2016-01-01,3,9320,1
Singapore,201601,1,350,350,350,12,894321,74526.75,766555,0.9992175894826143,13,69,11,3.277089431541257e-5,4,0.6177209617250203,2.4175026260566074e-4,2016-01-01,-11,894671,1
Guatemala,201601,1,5632,5632,5632,0,0,0,0,-1,1,0,0,2.8928757953774286e-7,6,0,0.0038901070828430894,2016-01-01,1,5632,1
Finland,201601,1,1,1,1,7,1093160,156165.714285714,805630,0.9999981704433291,8,589,12,0.024313676449045953,3,0.7550620487714403,6.907150360161736e-7,2016-01-01,-6,1093161,1
Ukraine,201601,1,4723,4723,4723,2,1809891,904945.5,1703159,0.9947944852183439,3,0,2,0.003435440592812097,2,1.2501189272503483,0.0032622471151043876,2016-01-01,-1,1814614,1
Paraguay,201601,0,0,0,0,1,12782,12782,12782,1,1,0,0,4.0464890774354e-8,2,0.008828719590358731,0,2016-01-01,-1,12782,1
Barbados,201601,0,0,0,0,4,4144,1036,2385,1,4,0,0,1.2760837807091753e-6,6,0.002862323109251023,0,2016-01-01,-4,4144,1
Iceland,201601,0,0,0,0,2,525,262.5,472,1,2,0,1,6.674494831243496e-6,2,3.626253939084911e-4,0,2016-01-01,-2,525,1
Montenegro,201601,0,0,0,0,4,40074,10018.5,12277,1,4,0,3,2.8302200606302217e-4,7,0.027679714353312138,0,2016-01-01,-4,40074,1
Malta,201601,0,0,0,0,2,11599,5799.5,8536,1,2,0,1,4.465550732913991e-5,2,0.008011603702751597,0,2016-01-01,-2,11599,1
Serbia,201601,0,0,0,0,3,184533,61511,99677,1,3,0,1,0.0022968510455149784,7,0.12745971774117257,0,2016-01-01,-3,184533,1
Bosnia Herzegovina,201601,0,0,0,0,3,42004,14001.3333333333,23059,1,3,0,1,6.310774815044606e-4,2,0.029012794372823354,0,2016-01-01,-3,42004,1
Pakistan,201601,0,0,0,0,1,4413,4413,4413,1,1,0,0,0,8,0.003048125453939374,0,2016-01-01,-1,4413,1
New Caledonia,201601,0,0,0,0,1,1390,1390,1390,1,1,0,0,8.073250731291904e-15,4,9.600939000624812e-4,0,2016-01-01,-1,1390,1
Kyrgyzstan,201601,0,0,0,0,1,44650,44650,44650,1,1,0,0,3.9281604120097877e-7,4,0.03084042635812215,0,2016-01-01,-1,44650,1
Niger,201601,0,0,0,0,1,5,5,5,1,1,0,0,2.2666555111410986e-8,1,3.453575180080868e-6,0,2016-01-01,-1,5,1
Saint Vincent and the Grenadines,201601,0,0,0,0,1,212,212,212,1,1,0,0,7.699637410609944e-9,6,1.464315876354288e-4,0,2016-01-01,-1,212,1
Antigua and Barbuda,201601,0,0,0,0,2,1792,896,1735,1,2,0,0,6.301354206169522e-8,6,0.001237761344540983,0,2016-01-01,-2,1792,1
TFYR of Macedonia,201601,0,0,0,0,1,117277,117277,117277,1,1,0,0,4.7446233732089136e-5,7,0.08100498727886879,0,2016-01-01,-1,117277,1
Algeria,201601,0,0,0,0,1,6659,6659,6659,1,1,0,0,5.8583695814412255e-8,4,0.0045994714248317,0,2016-01-01,-1,6659,1
Bahrain,201601,0,0,0,0,15,234390,15626,142505,1,15,0,22,3.051989967496357e-4,1,0.16189669729183093,0,2016-01-01,-15,234390,1
Bermuda,201601,0,0,0,0,1,25488,25488,25488,1,1,0,0,9.25699804249117e-7,6,0.01760494483798023,0,2016-01-01,-1,25488,1
Rep. of Moldova,201601,0,0,0,0,3,146212,48737.3333333333,133018,1,3,0,1,4.35698819424473e-5,2,0.10099082684599676,0,2016-01-01,-3,146212,1
Brunei Darussalam,201601,0,0,0,0,3,18049,6016.33333333333,17228,1,3,0,3,6.256126769316685e-9,4,0.012466715685055916,0,2016-01-01,-3,18049,1
Malawi,201601,0,0,0,0,1,900,900,900,1,1,0,0,7.480331687653285e-14,4,6.216435324145562e-4,0,2016-01-01,-1,900,1
Mozambique,201601,0,0,0,0,1,4920,4920,4920,1,1,0,0,4.0895155733946924e-13,4,0.003398317977199574,0,2016-01-01,-1,4920,1
Greenland,201601,0,0,0,0,3,11524,3841.33333333333,6584,1,3,0,3,2.0224020226327095e-5,2,0.007959800075050384,0,2016-01-01,-3,11524,1
